year,grade,total,girls,boys,x,State
2016-17,1,6053,2877,3176,A & N ISLANDS,A & N ISLANDS
2016-17,2,6109,3013,3096,A & N ISLANDS,A & N ISLANDS
2016-17,3,6171,3067,3104,A & N ISLANDS,A & N ISLANDS
2016-17,4,6184,3097,3087,A & N ISLANDS,A & N ISLANDS
2016-17,5,6161,2996,3165,A & N ISLANDS,A & N ISLANDS
2016-17,6,6252,3041,3211,A & N ISLANDS,A & N ISLANDS
2016-17,7,6069,3025,3044,A & N ISLANDS,A & N ISLANDS
2016-17,8,6146,3020,3126,A & N ISLANDS,A & N ISLANDS
2015-16,1,6259,3081,3178,A & N ISLANDS,A & N ISLANDS
2015-16,2,6295,3129,3166,A & N ISLANDS,A & N ISLANDS
2015-16,3,6288,3123,3165,A & N ISLANDS,A & N ISLANDS
2015-16,4,6229,3018,3211,A & N ISLANDS,A & N ISLANDS
2015-16,5,6335,3064,3271,A & N ISLANDS,A & N ISLANDS
2015-16,6,6294,3131,3163,A & N ISLANDS,A & N ISLANDS
2015-16,7,6273,3068,3205,A & N ISLANDS,A & N ISLANDS
2015-16,8,6140,2980,3160,A & N ISLANDS,A & N ISLANDS
2014-15,1,6415,3188,3227,A & N ISLANDS,A & N ISLANDS
2014-15,2,6332,3124,3208,A & N ISLANDS,A & N ISLANDS
2014-15,3,6266,3052,3214,A & N ISLANDS,A & N ISLANDS
2014-15,4,6345,3065,3280,A & N ISLANDS,A & N ISLANDS
2014-15,5,6267,3131,3136,A & N ISLANDS,A & N ISLANDS
2014-15,6,6385,3120,3265,A & N ISLANDS,A & N ISLANDS
2014-15,7,6359,3075,3284,A & N ISLANDS,A & N ISLANDS
2014-15,8,6458,3158,3300,A & N ISLANDS,A & N ISLANDS
2013-14,1,6453,3186,3267,A & N ISLANDS,A & N ISLANDS
2013-14,2,6404,3088,3316,A & N ISLANDS,A & N ISLANDS
2013-14,3,6393,3101,3292,A & N ISLANDS,A & N ISLANDS
2013-14,4,6290,3127,3163,A & N ISLANDS,A & N ISLANDS
2013-14,5,6447,3154,3293,A & N ISLANDS,A & N ISLANDS
2013-14,6,6438,3097,3341,A & N ISLANDS,A & N ISLANDS
2013-14,7,6562,3230,3332,A & N ISLANDS,A & N ISLANDS
2013-14,8,6716,3245,3471,A & N ISLANDS,A & N ISLANDS
2016-17,1,687854,298108,389746,ANDHRA PRADESH,ANDHRA PRADESH
2016-17,2,688423,329434,358989,ANDHRA PRADESH,ANDHRA PRADESH
2016-17,3,703811,338737,365074,ANDHRA PRADESH,ANDHRA PRADESH
2016-17,4,692445,333831,358614,ANDHRA PRADESH,ANDHRA PRADESH
2016-17,5,703238,339958,363280,ANDHRA PRADESH,ANDHRA PRADESH
2016-17,6,690110,333473,356637,ANDHRA PRADESH,ANDHRA PRADESH
2016-17,7,704494,340563,363931,ANDHRA PRADESH,ANDHRA PRADESH
2016-17,8,690345,334787,355558,ANDHRA PRADESH,ANDHRA PRADESH
2015-16,1,687345,329712,357633,ANDHRA PRADESH,ANDHRA PRADESH
2015-16,2,722695,347250,375445,ANDHRA PRADESH,ANDHRA PRADESH
2015-16,3,714981,344353,370628,ANDHRA PRADESH,ANDHRA PRADESH
2015-16,4,713279,344396,368883,ANDHRA PRADESH,ANDHRA PRADESH
2015-16,5,708388,342634,365754,ANDHRA PRADESH,ANDHRA PRADESH
2015-16,6,698983,338934,360049,ANDHRA PRADESH,ANDHRA PRADESH
2015-16,7,701191,340751,360440,ANDHRA PRADESH,ANDHRA PRADESH
2015-16,8,664448,323072,341376,ANDHRA PRADESH,ANDHRA PRADESH
2014-15,1,769860,370058,399802,ANDHRA PRADESH,ANDHRA PRADESH
2014-15,2,756964,365814,391150,ANDHRA PRADESH,ANDHRA PRADESH
2014-15,3,766641,371114,395527,ANDHRA PRADESH,ANDHRA PRADESH
2014-15,4,753353,365430,387923,ANDHRA PRADESH,ANDHRA PRADESH
2014-15,5,767938,372200,395738,ANDHRA PRADESH,ANDHRA PRADESH
2014-15,6,730099,354568,375531,ANDHRA PRADESH,ANDHRA PRADESH
2014-15,7,708092,345094,362998,ANDHRA PRADESH,ANDHRA PRADESH
2014-15,8,681449,330754,350695,ANDHRA PRADESH,ANDHRA PRADESH
2013-14,1,1523814,732608,791206,ANDHRA PRADESH,ANDHRA PRADESH
2013-14,2,1438735,697215,741520,ANDHRA PRADESH,ANDHRA PRADESH
2013-14,3,1433293,697264,736029,ANDHRA PRADESH,ANDHRA PRADESH
2013-14,4,1418565,689800,728765,ANDHRA PRADESH,ANDHRA PRADESH
2013-14,5,1404424,684217,720207,ANDHRA PRADESH,ANDHRA PRADESH
2013-14,6,1316848,644595,672253,ANDHRA PRADESH,ANDHRA PRADESH
2013-14,7,1311600,641974,669626,ANDHRA PRADESH,ANDHRA PRADESH
2013-14,8,1241936,613257,628679,ANDHRA PRADESH,ANDHRA PRADESH
2016-17,1,48920,23726,25194,ARUNACHAL PRADESH,ARUNACHAL PRADESH
2016-17,2,37930,18365,19565,ARUNACHAL PRADESH,ARUNACHAL PRADESH
2016-17,3,34485,16641,17844,ARUNACHAL PRADESH,ARUNACHAL PRADESH
2016-17,4,32457,15806,16651,ARUNACHAL PRADESH,ARUNACHAL PRADESH
2016-17,5,31520,15364,16156,ARUNACHAL PRADESH,ARUNACHAL PRADESH
2016-17,6,33154,17099,16055,ARUNACHAL PRADESH,ARUNACHAL PRADESH
2016-17,7,30756,15396,15360,ARUNACHAL PRADESH,ARUNACHAL PRADESH
2016-17,8,29322,14867,14455,ARUNACHAL PRADESH,ARUNACHAL PRADESH
2015-16,1,57224,27569,29655,ARUNACHAL PRADESH,ARUNACHAL PRADESH
2015-16,2,46920,22965,23955,ARUNACHAL PRADESH,ARUNACHAL PRADESH
2015-16,3,41839,20409,21430,ARUNACHAL PRADESH,ARUNACHAL PRADESH
2015-16,4,38503,18930,19573,ARUNACHAL PRADESH,ARUNACHAL PRADESH
2015-16,5,36744,18171,18573,ARUNACHAL PRADESH,ARUNACHAL PRADESH
2015-16,6,35501,17988,17513,ARUNACHAL PRADESH,ARUNACHAL PRADESH
2015-16,7,33235,16844,16391,ARUNACHAL PRADESH,ARUNACHAL PRADESH
2015-16,8,32492,16252,16240,ARUNACHAL PRADESH,ARUNACHAL PRADESH
2014-15,1,59217,28925,30292,ARUNACHAL PRADESH,ARUNACHAL PRADESH
2014-15,2,47416,23071,24345,ARUNACHAL PRADESH,ARUNACHAL PRADESH
2014-15,3,41921,20558,21363,ARUNACHAL PRADESH,ARUNACHAL PRADESH
2014-15,4,39060,19328,19732,ARUNACHAL PRADESH,ARUNACHAL PRADESH
2014-15,5,36430,17770,18660,ARUNACHAL PRADESH,ARUNACHAL PRADESH
2014-15,6,35302,18038,17264,ARUNACHAL PRADESH,ARUNACHAL PRADESH
2014-15,7,33824,16955,16869,ARUNACHAL PRADESH,ARUNACHAL PRADESH
2014-15,8,32123,16022,16101,ARUNACHAL PRADESH,ARUNACHAL PRADESH
2013-14,1,61954,30323,31631,ARUNACHAL PRADESH,ARUNACHAL PRADESH
2013-14,2,46032,22444,23588,ARUNACHAL PRADESH,ARUNACHAL PRADESH
2013-14,3,42696,21065,21631,ARUNACHAL PRADESH,ARUNACHAL PRADESH
2013-14,4,38723,18906,19817,ARUNACHAL PRADESH,ARUNACHAL PRADESH
2013-14,5,35647,17451,18196,ARUNACHAL PRADESH,ARUNACHAL PRADESH
2013-14,6,35399,17711,17688,ARUNACHAL PRADESH,ARUNACHAL PRADESH
2013-14,7,33056,16529,16527,ARUNACHAL PRADESH,ARUNACHAL PRADESH
2013-14,8,31540,15807,15733,ARUNACHAL PRADESH,ARUNACHAL PRADESH
2016-17,1,875921,430459,445462,assam,ASSAM
2016-17,2,786392,387996,398396,assam,ASSAM
2016-17,3,735270,364298,370972,assam,ASSAM
2016-17,4,697197,346613,350584,assam,ASSAM
2016-17,5,670991,334642,336349,assam,ASSAM
2016-17,6,621569,318372,303197,assam,ASSAM
2016-17,7,591969,305379,286590,assam,ASSAM
2016-17,8,564533,293201,271332,assam,ASSAM
2015-16,1,898488,440217,458271,assam,ASSAM
2015-16,2,759411,375054,384357,assam,ASSAM
2015-16,3,717958,356128,361830,assam,ASSAM
2015-16,4,682790,340524,342266,assam,ASSAM
2015-16,5,662274,332441,329833,assam,ASSAM
2015-16,6,604319,309824,294495,assam,ASSAM
2015-16,7,568873,294201,274672,assam,ASSAM
2015-16,8,537940,279266,258674,assam,ASSAM
2014-15,1,968591,475558,493033,assam,ASSAM
2014-15,2,835361,412410,422951,assam,ASSAM
2014-15,3,790059,391817,398242,assam,ASSAM
2014-15,4,752075,375972,376103,assam,ASSAM
2014-15,5,703557,352743,350814,assam,ASSAM
2014-15,6,631819,325823,305996,assam,ASSAM
2014-15,7,593778,307737,286041,assam,ASSAM
2014-15,8,578038,300081,277957,assam,ASSAM
2013-14,1,958267,471152,487115,assam,ASSAM
2013-14,2,836816,413222,423594,assam,ASSAM
2013-14,3,794914,396082,398832,assam,ASSAM
2013-14,4,737158,368099,369059,assam,ASSAM
2013-14,5,686551,344561,341990,assam,ASSAM
2013-14,6,613097,315440,297657,assam,ASSAM
2013-14,7,591435,305582,285853,assam,ASSAM
2013-14,8,587946,304371,283575,assam,ASSAM
2016-17,1,2539841,1244743,1295098,bihar,BIHAR
2016-17,2,3140218,1559440,1580778,bihar,BIHAR
2016-17,3,3052098,1525686,1526412,bihar,BIHAR
2016-17,4,3073569,1528854,1544715,bihar,BIHAR
2016-17,5,2923359,1452790,1470569,bihar,BIHAR
2016-17,6,2396390,1204696,1191694,bihar,BIHAR
2016-17,7,2373857,1210570,1163287,bihar,BIHAR
2016-17,8,2220132,1130593,1089539,bihar,BIHAR
2015-16,1,3392382,1666299,1726083,bihar,BIHAR
2015-16,2,3194536,1586682,1607854,bihar,BIHAR
2015-16,3,3305396,1632816,1672580,bihar,BIHAR
2015-16,4,3139774,1552067,1587707,bihar,BIHAR
2015-16,5,3138000,1557235,1580765,bihar,BIHAR
2015-16,6,2550091,1286962,1263129,bihar,BIHAR
2015-16,7,2407456,1215344,1192112,bihar,BIHAR
2015-16,8,2304150,1170384,1133766,bihar,BIHAR
2014-15,1,3055066,1500673,1554393,bihar,BIHAR
2014-15,2,3147730,1550821,1596909,bihar,BIHAR
2014-15,3,3083682,1520905,1562777,bihar,BIHAR
2014-15,4,3061106,1515064,1546042,bihar,BIHAR
2014-15,5,2992885,1493188,1499697,bihar,BIHAR
2014-15,6,2376666,1195671,1180995,bihar,BIHAR
2014-15,7,2293249,1162765,1130484,bihar,BIHAR
2014-15,8,2122733,1077217,1045516,bihar,BIHAR
2013-14,1,3129256,1529516,1599740,bihar,BIHAR
2013-14,2,2971831,1461738,1510093,bihar,BIHAR
2013-14,3,3057382,1511932,1545450,bihar,BIHAR
2013-14,4,2996389,1496470,1499919,bihar,BIHAR
2013-14,5,2865897,1430961,1434936,bihar,BIHAR
2013-14,6,2307584,1166037,1141547,bihar,BIHAR
2013-14,7,2141782,1086119,1055663,bihar,BIHAR
2013-14,8,1768836,887578,881258,bihar,BIHAR
2016-17,1,15852,7458,8394,chandigarh,CHANDIGARH
2016-17,2,16905,7921,8984,chandigarh,CHANDIGARH
2016-17,3,18945,8924,10021,chandigarh,CHANDIGARH
2016-17,4,19683,9215,10468,chandigarh,CHANDIGARH
2016-17,5,20275,9222,11053,chandigarh,CHANDIGARH
2016-17,6,21417,9773,11644,chandigarh,CHANDIGARH
2016-17,7,21629,9903,11726,chandigarh,CHANDIGARH
2016-17,8,21692,9913,11779,chandigarh,CHANDIGARH
2015-16,1,15688,7390,8298,chandigarh,CHANDIGARH
2015-16,2,17782,8420,9362,chandigarh,CHANDIGARH
2015-16,3,19074,9019,10055,chandigarh,CHANDIGARH
2015-16,4,19983,9159,10824,chandigarh,CHANDIGARH
2015-16,5,20703,9584,11119,chandigarh,CHANDIGARH
2015-16,6,21642,10019,11623,chandigarh,CHANDIGARH
2015-16,7,21754,10051,11703,chandigarh,CHANDIGARH
2015-16,8,21295,9488,11807,chandigarh,CHANDIGARH
2014-15,1,16693,7908,8785,chandigarh,CHANDIGARH
2014-15,2,18373,8684,9689,chandigarh,CHANDIGARH
2014-15,3,19582,9007,10575,chandigarh,CHANDIGARH
2014-15,4,20550,9477,11073,chandigarh,CHANDIGARH
2014-15,5,21169,9869,11300,chandigarh,CHANDIGARH
2014-15,6,21711,10140,11571,chandigarh,CHANDIGARH
2014-15,7,21344,9555,11789,chandigarh,CHANDIGARH
2014-15,8,21321,9406,11915,chandigarh,CHANDIGARH
2013-14,1,16894,7965,8929,chandigarh,CHANDIGARH
2013-14,2,18591,8572,10019,chandigarh,CHANDIGARH
2013-14,3,19937,9283,10654,chandigarh,CHANDIGARH
2013-14,4,20775,9771,11004,chandigarh,CHANDIGARH
2013-14,5,21327,10059,11268,chandigarh,CHANDIGARH
2013-14,6,21688,9729,11959,chandigarh,CHANDIGARH
2013-14,7,21475,9563,11912,chandigarh,CHANDIGARH
2013-14,8,20498,8848,11650,chandigarh,CHANDIGARH
2016-17,1,558819,272286,286533,chhattisgarh,CHHATTISGARH
2016-17,2,542253,264247,278006,chhattisgarh,CHHATTISGARH
2016-17,3,538826,263374,275452,chhattisgarh,CHHATTISGARH
2016-17,4,524474,256385,268089,chhattisgarh,CHHATTISGARH
2016-17,5,546324,267360,278964,chhattisgarh,CHHATTISGARH
2016-17,6,548556,270250,278306,chhattisgarh,CHHATTISGARH
2016-17,7,559124,276271,282853,chhattisgarh,CHHATTISGARH
2016-17,8,531875,266455,265420,chhattisgarh,CHHATTISGARH
2015-16,1,566422,275625,290797,chhattisgarh,CHHATTISGARH
2015-16,2,551042,268807,282235,chhattisgarh,CHHATTISGARH
2015-16,3,537285,262229,275056,chhattisgarh,CHHATTISGARH
2015-16,4,560407,274406,286001,chhattisgarh,CHHATTISGARH
2015-16,5,577849,283483,294366,chhattisgarh,CHHATTISGARH
2015-16,6,575773,282756,293017,chhattisgarh,CHHATTISGARH
2015-16,7,550874,272678,278196,chhattisgarh,CHHATTISGARH
2015-16,8,537703,265137,272566,chhattisgarh,CHHATTISGARH
2014-15,1,572318,278290,294028,chhattisgarh,CHHATTISGARH
2014-15,2,545836,265973,279863,chhattisgarh,CHHATTISGARH
2014-15,3,572244,279417,292827,chhattisgarh,CHHATTISGARH
2014-15,4,589735,289507,300228,chhattisgarh,CHHATTISGARH
2014-15,5,607806,297883,309923,chhattisgarh,CHHATTISGARH
2014-15,6,564638,278324,286314,chhattisgarh,CHHATTISGARH
2014-15,7,552685,270172,282513,chhattisgarh,CHHATTISGARH
2014-15,8,543418,268859,274559,chhattisgarh,CHHATTISGARH
2013-14,1,552007,269018,282989,chhattisgarh,CHHATTISGARH
2013-14,2,574030,280628,293402,chhattisgarh,CHHATTISGARH
2013-14,3,596223,292286,303937,chhattisgarh,CHHATTISGARH
2013-14,4,613171,300206,312965,chhattisgarh,CHHATTISGARH
2013-14,5,587512,289298,298214,chhattisgarh,CHHATTISGARH
2013-14,6,557699,272545,285154,chhattisgarh,CHHATTISGARH
2013-14,7,548693,270949,277744,chhattisgarh,CHHATTISGARH
2013-14,8,560229,278443,281786,chhattisgarh,CHHATTISGARH
2016-17,1,8029,3693,4336,dadra & nagar haveli,DADRA & NAGAR HAVELI
2016-17,2,9030,4256,4774,dadra & nagar haveli,DADRA & NAGAR HAVELI
2016-17,3,7500,3592,3908,dadra & nagar haveli,DADRA & NAGAR HAVELI
2016-17,4,7722,3614,4108,dadra & nagar haveli,DADRA & NAGAR HAVELI
2016-17,5,4066,1836,2230,dadra & nagar haveli,DADRA & NAGAR HAVELI
2016-17,6,7945,3759,4186,dadra & nagar haveli,DADRA & NAGAR HAVELI
2016-17,7,7682,3575,4107,dadra & nagar haveli,DADRA & NAGAR HAVELI
2016-17,8,7306,3377,3929,dadra & nagar haveli,DADRA & NAGAR HAVELI
2015-16,1,9102,4271,4831,dadra & nagar haveli,DADRA & NAGAR HAVELI
2015-16,2,7560,3620,3940,dadra & nagar haveli,DADRA & NAGAR HAVELI
2015-16,3,7618,3565,4053,dadra & nagar haveli,DADRA & NAGAR HAVELI
2015-16,4,4015,1794,2221,dadra & nagar haveli,DADRA & NAGAR HAVELI
2015-16,5,7901,3740,4161,dadra & nagar haveli,DADRA & NAGAR HAVELI
2015-16,6,7737,3576,4161,dadra & nagar haveli,DADRA & NAGAR HAVELI
2015-16,7,7451,3458,3993,dadra & nagar haveli,DADRA & NAGAR HAVELI
2015-16,8,7590,3548,4042,dadra & nagar haveli,DADRA & NAGAR HAVELI
2014-15,1,7702,3685,4017,dadra & nagar haveli,DADRA & NAGAR HAVELI
2014-15,2,7787,3589,4198,dadra & nagar haveli,DADRA & NAGAR HAVELI
2014-15,3,4028,1806,2222,dadra & nagar haveli,DADRA & NAGAR HAVELI
2014-15,4,8027,3802,4225,dadra & nagar haveli,DADRA & NAGAR HAVELI
2014-15,5,7814,3627,4187,dadra & nagar haveli,DADRA & NAGAR HAVELI
2014-15,6,7601,3512,4089,dadra & nagar haveli,DADRA & NAGAR HAVELI
2014-15,7,7812,3639,4173,dadra & nagar haveli,DADRA & NAGAR HAVELI
2014-15,8,7426,3377,4049,dadra & nagar haveli,DADRA & NAGAR HAVELI
2013-14,1,7894,3658,4236,dadra & nagar haveli,DADRA & NAGAR HAVELI
2013-14,2,4099,1869,2230,dadra & nagar haveli,DADRA & NAGAR HAVELI
2013-14,3,8177,3895,4282,dadra & nagar haveli,DADRA & NAGAR HAVELI
2013-14,4,7889,3676,4213,dadra & nagar haveli,DADRA & NAGAR HAVELI
2013-14,5,7763,3607,4156,dadra & nagar haveli,DADRA & NAGAR HAVELI
2013-14,6,8018,3759,4259,dadra & nagar haveli,DADRA & NAGAR HAVELI
2013-14,7,7664,3498,4166,dadra & nagar haveli,DADRA & NAGAR HAVELI
2013-14,8,7289,3361,3928,dadra & nagar haveli,DADRA & NAGAR HAVELI
2016-17,1,3724,1744,1980,daman & diu,DAMAN & DIU
2016-17,2,3751,1787,1964,daman & diu,DAMAN & DIU
2016-17,3,3786,1814,1972,daman & diu,DAMAN & DIU
2016-17,4,3568,1632,1936,daman & diu,DAMAN & DIU
2016-17,5,3743,1738,2005,daman & diu,DAMAN & DIU
2016-17,6,3511,1602,1909,daman & diu,DAMAN & DIU
2016-17,7,3326,1554,1772,daman & diu,DAMAN & DIU
2016-17,8,3242,1518,1724,daman & diu,DAMAN & DIU
2015-16,1,3575,1670,1905,daman & diu,DAMAN & DIU
2015-16,2,3760,1768,1992,daman & diu,DAMAN & DIU
2015-16,3,3560,1627,1933,daman & diu,DAMAN & DIU
2015-16,4,3726,1716,2010,daman & diu,DAMAN & DIU
2015-16,5,3524,1607,1917,daman & diu,DAMAN & DIU
2015-16,6,3386,1562,1824,daman & diu,DAMAN & DIU
2015-16,7,3277,1547,1730,daman & diu,DAMAN & DIU
2015-16,8,3170,1498,1672,daman & diu,DAMAN & DIU
2014-15,1,3598,1679,1919,daman & diu,DAMAN & DIU
2014-15,2,3606,1650,1956,daman & diu,DAMAN & DIU
2014-15,3,3826,1725,2101,daman & diu,DAMAN & DIU
2014-15,4,3603,1646,1957,daman & diu,DAMAN & DIU
2014-15,5,3526,1606,1920,daman & diu,DAMAN & DIU
2014-15,6,3430,1606,1824,daman & diu,DAMAN & DIU
2014-15,7,3295,1544,1751,daman & diu,DAMAN & DIU
2014-15,8,3273,1474,1799,daman & diu,DAMAN & DIU
2013-14,1,3525,1606,1919,daman & diu,DAMAN & DIU
2013-14,2,3869,1766,2103,daman & diu,DAMAN & DIU
2013-14,3,3662,1657,2005,daman & diu,DAMAN & DIU
2013-14,4,3532,1612,1920,daman & diu,DAMAN & DIU
2013-14,5,3564,1647,1917,daman & diu,DAMAN & DIU
2013-14,6,3481,1638,1843,daman & diu,DAMAN & DIU
2013-14,7,3426,1555,1871,daman & diu,DAMAN & DIU
2013-14,8,3102,1431,1671,daman & diu,DAMAN & DIU
2016-17,1,335091,157994,177097,delhi,DELHI
2016-17,2,362778,171495,191283,delhi,DELHI
2016-17,3,381469,179966,201503,delhi,DELHI
2016-17,4,381868,177373,204495,delhi,DELHI
2016-17,5,399916,183751,216165,delhi,DELHI
2016-17,6,384296,178966,205330,delhi,DELHI
2016-17,7,373991,175043,198948,delhi,DELHI
2016-17,8,369092,171318,197774,delhi,DELHI
2015-16,1,344298,163184,181114,delhi,DELHI
2015-16,2,370904,175583,195321,delhi,DELHI
2015-16,3,377912,176382,201530,delhi,DELHI
2015-16,4,385629,178000,207629,delhi,DELHI
2015-16,5,408231,186538,221693,delhi,DELHI
2015-16,6,379567,177009,202558,delhi,DELHI
2015-16,7,369204,171817,197387,delhi,DELHI
2015-16,8,371265,175645,195620,delhi,DELHI
2014-15,1,345644,164833,180811,delhi,DELHI
2014-15,2,363293,170382,192911,delhi,DELHI
2014-15,3,376026,175125,200901,delhi,DELHI
2014-15,4,390043,179618,210425,delhi,DELHI
2014-15,5,400508,183460,217048,delhi,DELHI
2014-15,6,376386,174165,202221,delhi,DELHI
2014-15,7,372615,176627,195988,delhi,DELHI
2014-15,8,366552,168354,198198,delhi,DELHI
2013-14,1,329237,155718,173519,delhi,DELHI
2013-14,2,355773,166875,188898,delhi,DELHI
2013-14,3,378517,175560,202957,delhi,DELHI
2013-14,4,380314,175660,204654,delhi,DELHI
2013-14,5,384900,175645,209255,delhi,DELHI
2013-14,6,384000,181430,202570,delhi,DELHI
2013-14,7,370305,169641,200664,delhi,DELHI
2013-14,8,361145,164950,196195,delhi,DELHI
2016-17,1,24846,11786,13060,goa,GOA
2016-17,2,24757,11893,12864,goa,GOA
2016-17,3,24208,11560,12648,goa,GOA
2016-17,4,24177,11657,12520,goa,GOA
2016-17,5,24302,11536,12766,goa,GOA
2016-17,6,23883,11418,12465,goa,GOA
2016-17,7,23921,11389,12532,goa,GOA
2016-17,8,23490,11104,12386,goa,GOA
2015-16,1,25371,12128,13243,goa,GOA
2015-16,2,24728,11902,12826,goa,GOA
2015-16,3,24571,11890,12681,goa,GOA
2015-16,4,24711,11828,12883,goa,GOA
2015-16,5,24407,11656,12751,goa,GOA
2015-16,6,24492,11706,12786,goa,GOA
2015-16,7,23902,11373,12529,goa,GOA
2015-16,8,24127,11499,12628,goa,GOA
2014-15,1,25297,12176,13121,goa,GOA
2014-15,2,24635,11964,12671,goa,GOA
2014-15,3,24764,11819,12945,goa,GOA
2014-15,4,24673,11845,12828,goa,GOA
2014-15,5,24486,11694,12792,goa,GOA
2014-15,6,24016,11412,12604,goa,GOA
2014-15,7,24267,11514,12753,goa,GOA
2014-15,8,24390,11681,12709,goa,GOA
2013-14,1,24722,11986,12736,goa,GOA
2013-14,2,24768,11856,12912,goa,GOA
2013-14,3,24694,11852,12842,goa,GOA
2013-14,4,24659,11848,12811,goa,GOA
2013-14,5,23977,11387,12590,goa,GOA
2013-14,6,24378,11579,12799,goa,GOA
2013-14,7,24389,11659,12730,goa,GOA
2013-14,8,26497,12295,14202,goa,GOA
2016-17,1,1126865,529918,596947,gujarat,GUJARAT
2016-17,2,1105071,520978,584093,gujarat,GUJARAT
2016-17,3,1029067,484873,544194,gujarat,GUJARAT
2016-17,4,1117426,529153,588273,gujarat,GUJARAT
2016-17,5,1137889,534405,603484,gujarat,GUJARAT
2016-17,6,1202839,555581,647258,gujarat,GUJARAT
2016-17,7,1169111,535695,633416,gujarat,GUJARAT
2016-17,8,1123905,506960,616945,gujarat,GUJARAT
2015-16,1,1125292,529172,596120,gujarat,GUJARAT
2015-16,2,1033847,486937,546910,gujarat,GUJARAT
2015-16,3,1122324,531396,590928,gujarat,GUJARAT
2015-16,4,1138115,536672,601443,gujarat,GUJARAT
2015-16,5,1228467,568864,659603,gujarat,GUJARAT
2015-16,6,1190336,546625,643711,gujarat,GUJARAT
2015-16,7,1157420,525782,631638,gujarat,GUJARAT
2015-16,8,1094913,491614,603299,gujarat,GUJARAT
2014-15,1,1049069,493198,555871,gujarat,GUJARAT
2014-15,2,1126299,533239,593060,gujarat,GUJARAT
2014-15,3,1141293,538632,602661,gujarat,GUJARAT
2014-15,4,1235991,573474,662517,gujarat,GUJARAT
2014-15,5,1212030,558403,653627,gujarat,GUJARAT
2014-15,6,1175504,536138,639366,gujarat,GUJARAT
2014-15,7,1124975,509774,615201,gujarat,GUJARAT
2014-15,8,1077290,479173,598117,gujarat,GUJARAT
2013-14,1,1143578,541609,601969,gujarat,GUJARAT
2013-14,2,1144016,540988,603028,gujarat,GUJARAT
2013-14,3,1239427,576636,662791,gujarat,GUJARAT
2013-14,4,1216335,562824,653511,gujarat,GUJARAT
2013-14,5,1193211,547422,645789,gujarat,GUJARAT
2013-14,6,1135195,517370,617825,gujarat,GUJARAT
2013-14,7,1100411,494985,605426,gujarat,GUJARAT
2013-14,8,1057298,468724,588574,gujarat,GUJARAT
2016-17,1,483485,216444,267041,haryana,HARYANA
2016-17,2,463560,207541,256019,haryana,HARYANA
2016-17,3,478811,216144,262667,haryana,HARYANA
2016-17,4,481192,218507,262685,haryana,HARYANA
2016-17,5,493085,222739,270346,haryana,HARYANA
2016-17,6,483828,218617,265211,haryana,HARYANA
2016-17,7,468046,210605,257441,haryana,HARYANA
2016-17,8,472895,213677,259218,haryana,HARYANA
2015-16,1,446753,199636,247117,haryana,HARYANA
2015-16,2,460006,209105,250901,haryana,HARYANA
2015-16,3,471626,215776,255850,haryana,HARYANA
2015-16,4,474073,216416,257657,haryana,HARYANA
2015-16,5,484192,220897,263295,haryana,HARYANA
2015-16,6,462554,208937,253617,haryana,HARYANA
2015-16,7,469500,213487,256013,haryana,HARYANA
2015-16,8,462240,209948,252292,haryana,HARYANA
2014-15,1,487663,220446,267217,haryana,HARYANA
2014-15,2,498618,228207,270411,haryana,HARYANA
2014-15,3,503071,229417,273654,haryana,HARYANA
2014-15,4,504968,231331,273637,haryana,HARYANA
2014-15,5,499258,226977,272281,haryana,HARYANA
2014-15,6,496892,225513,271379,haryana,HARYANA
2014-15,7,487156,220637,266519,haryana,HARYANA
2014-15,8,476340,213403,262937,haryana,HARYANA
2013-14,1,496699,226311,270388,haryana,HARYANA
2013-14,2,500048,228625,271423,haryana,HARYANA
2013-14,3,510444,234667,275777,haryana,HARYANA
2013-14,4,495898,226625,269273,haryana,HARYANA
2013-14,5,510774,232808,277966,haryana,HARYANA
2013-14,6,494855,224472,270383,haryana,HARYANA
2013-14,7,479662,215502,264160,haryana,HARYANA
2013-14,8,468343,209350,258993,haryana,HARYANA
2016-17,1,117775,55920,61855,himachal pradesh,HIMACHAL PRADESH
2016-17,2,117149,56314,60835,himachal pradesh,HIMACHAL PRADESH
2016-17,3,115811,55576,60235,himachal pradesh,HIMACHAL PRADESH
2016-17,4,113363,53876,59487,himachal pradesh,HIMACHAL PRADESH
2016-17,5,111768,52816,58952,himachal pradesh,HIMACHAL PRADESH
2016-17,6,117986,55666,62320,himachal pradesh,HIMACHAL PRADESH
2016-17,7,122314,58195,64119,himachal pradesh,HIMACHAL PRADESH
2016-17,8,124508,59071,65437,himachal pradesh,HIMACHAL PRADESH
2015-16,1,118799,56914,61885,himachal pradesh,HIMACHAL PRADESH
2015-16,2,116754,56249,60505,himachal pradesh,HIMACHAL PRADESH
2015-16,3,114047,54495,59552,himachal pradesh,HIMACHAL PRADESH
2015-16,4,112502,53153,59349,himachal pradesh,HIMACHAL PRADESH
2015-16,5,119011,56365,62646,himachal pradesh,HIMACHAL PRADESH
2015-16,6,122692,58336,64356,himachal pradesh,HIMACHAL PRADESH
2015-16,7,125153,59576,65577,himachal pradesh,HIMACHAL PRADESH
2015-16,8,121808,57629,64179,himachal pradesh,HIMACHAL PRADESH
2014-15,1,117639,56424,61215,himachal pradesh,HIMACHAL PRADESH
2014-15,2,114093,54545,59548,himachal pradesh,HIMACHAL PRADESH
2014-15,3,113088,53727,59361,himachal pradesh,HIMACHAL PRADESH
2014-15,4,119252,56622,62630,himachal pradesh,HIMACHAL PRADESH
2014-15,5,124689,59627,65062,himachal pradesh,HIMACHAL PRADESH
2014-15,6,125456,59731,65725,himachal pradesh,HIMACHAL PRADESH
2014-15,7,122101,57986,64115,himachal pradesh,HIMACHAL PRADESH
2014-15,8,122413,57756,64657,himachal pradesh,HIMACHAL PRADESH
2013-14,1,114687,54693,59994,himachal pradesh,HIMACHAL PRADESH
2013-14,2,112683,53518,59165,himachal pradesh,HIMACHAL PRADESH
2013-14,3,119496,56690,62806,himachal pradesh,HIMACHAL PRADESH
2013-14,4,125007,59757,65250,himachal pradesh,HIMACHAL PRADESH
2013-14,5,127198,60419,66779,himachal pradesh,HIMACHAL PRADESH
2013-14,6,122618,58181,64437,himachal pradesh,HIMACHAL PRADESH
2013-14,7,122564,57893,64671,himachal pradesh,HIMACHAL PRADESH
2013-14,8,124842,58287,66555,himachal pradesh,HIMACHAL PRADESH
2016-17,1,246925,117204,129721,jammu & kashmir,JAMMU & KASHMIR
2016-17,2,230173,109295,120878,jammu & kashmir,JAMMU & KASHMIR
2016-17,3,216431,102429,114002,jammu & kashmir,JAMMU & KASHMIR
2016-17,4,214292,101428,112864,jammu & kashmir,JAMMU & KASHMIR
2016-17,5,212023,100472,111551,jammu & kashmir,JAMMU & KASHMIR
2016-17,6,197789,93485,104304,jammu & kashmir,JAMMU & KASHMIR
2016-17,7,190589,89957,100632,jammu & kashmir,JAMMU & KASHMIR
2016-17,8,184837,86372,98465,jammu & kashmir,JAMMU & KASHMIR
2015-16,1,300528,143926,156602,jammu & kashmir,JAMMU & KASHMIR
2015-16,2,247737,117978,129759,jammu & kashmir,JAMMU & KASHMIR
2015-16,3,240351,114864,125487,jammu & kashmir,JAMMU & KASHMIR
2015-16,4,235151,112619,122532,jammu & kashmir,JAMMU & KASHMIR
2015-16,5,225286,107642,117644,jammu & kashmir,JAMMU & KASHMIR
2015-16,6,210355,100578,109777,jammu & kashmir,JAMMU & KASHMIR
2015-16,7,200631,95389,105242,jammu & kashmir,JAMMU & KASHMIR
2015-16,8,196737,93203,103534,jammu & kashmir,JAMMU & KASHMIR
2014-15,1,293789,139698,154091,jammu & kashmir,JAMMU & KASHMIR
2014-15,2,251464,119817,131647,jammu & kashmir,JAMMU & KASHMIR
2014-15,3,243874,116564,127310,jammu & kashmir,JAMMU & KASHMIR
2014-15,4,230618,110087,120531,jammu & kashmir,JAMMU & KASHMIR
2014-15,5,224178,106858,117320,jammu & kashmir,JAMMU & KASHMIR
2014-15,6,205632,97842,107790,jammu & kashmir,JAMMU & KASHMIR
2014-15,7,199954,94915,105039,jammu & kashmir,JAMMU & KASHMIR
2014-15,8,203537,96380,107157,jammu & kashmir,JAMMU & KASHMIR
2013-14,1,285555,136035,149520,jammu & kashmir,JAMMU & KASHMIR
2013-14,2,254463,121448,133015,jammu & kashmir,JAMMU & KASHMIR
2013-14,3,238709,113902,124807,jammu & kashmir,JAMMU & KASHMIR
2013-14,4,228327,108923,119404,jammu & kashmir,JAMMU & KASHMIR
2013-14,5,216408,102759,113649,jammu & kashmir,JAMMU & KASHMIR
2013-14,6,203292,96688,106604,jammu & kashmir,JAMMU & KASHMIR
2013-14,7,203246,96490,106756,jammu & kashmir,JAMMU & KASHMIR
2013-14,8,211178,99730,111448,jammu & kashmir,JAMMU & KASHMIR
2016-17,1,854261,404799,449462,jharkhand,JHARKHAND
2016-17,2,817062,395964,421098,jharkhand,JHARKHAND
2016-17,3,773521,374583,398938,jharkhand,JHARKHAND
2016-17,4,764765,374363,390402,jharkhand,JHARKHAND
2016-17,5,730867,356710,374157,jharkhand,JHARKHAND
2016-17,6,653640,324575,329065,jharkhand,JHARKHAND
2016-17,7,608632,304003,304629,jharkhand,JHARKHAND
2016-17,8,586393,294550,291843,jharkhand,JHARKHAND
2015-16,1,977183,474538,502645,jharkhand,JHARKHAND
2015-16,2,885600,430605,454995,jharkhand,JHARKHAND
2015-16,3,892007,438143,453864,jharkhand,JHARKHAND
2015-16,4,848889,417088,431801,jharkhand,JHARKHAND
2015-16,5,849848,418836,431012,jharkhand,JHARKHAND
2015-16,6,713279,356170,357109,jharkhand,JHARKHAND
2015-16,7,688597,345606,342991,jharkhand,JHARKHAND
2015-16,8,666665,336789,329876,jharkhand,JHARKHAND
2014-15,1,947269,457355,489914,jharkhand,JHARKHAND
2014-15,2,907981,445022,462959,jharkhand,JHARKHAND
2014-15,3,882913,433414,449499,jharkhand,JHARKHAND
2014-15,4,883386,434270,449116,jharkhand,JHARKHAND
2014-15,5,841818,414922,426896,jharkhand,JHARKHAND
2014-15,6,720552,358994,361558,jharkhand,JHARKHAND
2014-15,7,686237,343370,342867,jharkhand,JHARKHAND
2014-15,8,670633,337266,333367,jharkhand,JHARKHAND
2013-14,1,1029504,501661,527843,jharkhand,JHARKHAND
2013-14,2,904261,441443,462818,jharkhand,JHARKHAND
2013-14,3,924275,453269,471006,jharkhand,JHARKHAND
2013-14,4,860285,422407,437878,jharkhand,JHARKHAND
2013-14,5,864434,426301,438133,jharkhand,JHARKHAND
2013-14,6,701201,349205,351996,jharkhand,JHARKHAND
2013-14,7,679054,339481,339573,jharkhand,JHARKHAND
2013-14,8,662009,332789,329220,jharkhand,JHARKHAND
2016-17,1,1110988,529655,581333,karnataka,KARNATAKA
2016-17,2,1101337,528841,572496,karnataka,KARNATAKA
2016-17,3,1099542,531535,568007,karnataka,KARNATAKA
2016-17,4,1073751,518901,554850,karnataka,KARNATAKA
2016-17,5,1058728,514158,544570,karnataka,KARNATAKA
2016-17,6,996519,473415,523104,karnataka,KARNATAKA
2016-17,7,987519,473371,514148,karnataka,KARNATAKA
2016-17,8,935455,447592,487863,karnataka,KARNATAKA
2015-16,1,1136667,548958,587709,karnataka,KARNATAKA
2015-16,2,1103563,536006,567557,karnataka,KARNATAKA
2015-16,3,1078987,524279,554708,karnataka,KARNATAKA
2015-16,4,1062715,519542,543173,karnataka,KARNATAKA
2015-16,5,1024314,489951,534363,karnataka,KARNATAKA
2015-16,6,994356,480188,514168,karnataka,KARNATAKA
2015-16,7,978036,472662,505374,karnataka,KARNATAKA
2015-16,8,961735,462741,498994,karnataka,KARNATAKA
2014-15,1,1137328,551301,586027,karnataka,KARNATAKA
2014-15,2,1095878,532198,563680,karnataka,KARNATAKA
2014-15,3,1077944,526827,551117,karnataka,KARNATAKA
2014-15,4,1036938,496904,540034,karnataka,KARNATAKA
2014-15,5,1025936,495767,530169,karnataka,KARNATAKA
2014-15,6,989715,479532,510183,karnataka,KARNATAKA
2014-15,7,991606,480243,511363,karnataka,KARNATAKA
2014-15,8,990403,474682,515721,karnataka,KARNATAKA
2013-14,1,1134033,550534,583499,karnataka,KARNATAKA
2013-14,2,1100937,536756,564181,karnataka,KARNATAKA
2013-14,3,1055151,505440,549711,karnataka,KARNATAKA
2013-14,4,1041599,503430,538169,karnataka,KARNATAKA
2013-14,5,1020903,493464,527439,karnataka,KARNATAKA
2013-14,6,999135,483698,515437,karnataka,KARNATAKA
2013-14,7,1009437,486702,522735,karnataka,KARNATAKA
2013-14,8,962361,459883,502478,karnataka,KARNATAKA
2016-17,1,490072,239436,250636,kerala,KERALA
2016-17,2,494988,241702,253286,kerala,KERALA
2016-17,3,491513,240613,250900,kerala,KERALA
2016-17,4,488356,238358,249998,kerala,KERALA
2016-17,5,495910,242419,253491,kerala,KERALA
2016-17,6,495822,242762,253060,kerala,KERALA
2016-17,7,501816,244702,257114,kerala,KERALA
2016-17,8,517666,252890,264776,kerala,KERALA
2015-16,1,499125,243601,255524,kerala,KERALA
2015-16,2,490461,239911,250550,kerala,KERALA
2015-16,3,488085,238658,249427,kerala,KERALA
2015-16,4,496239,241799,254440,kerala,KERALA
2015-16,5,494719,242399,252320,kerala,KERALA
2015-16,6,501952,244619,257333,kerala,KERALA
2015-16,7,516234,252326,263908,kerala,KERALA
2015-16,8,525601,256314,269287,kerala,KERALA
2014-15,1,494343,241853,252490,kerala,KERALA
2014-15,2,486490,237599,248891,kerala,KERALA
2014-15,3,493133,240241,252892,kerala,KERALA
2014-15,4,493498,241497,252001,kerala,KERALA
2014-15,5,499816,243660,256156,kerala,KERALA
2014-15,6,515381,251667,263714,kerala,KERALA
2014-15,7,525230,255284,269946,kerala,KERALA
2014-15,8,541423,263687,277736,kerala,KERALA
2013-14,1,490287,239088,251199,kerala,KERALA
2013-14,3,490056,238833,251223,kerala,KERALA
2013-14,4,491116,240037,251079,kerala,KERALA
2013-14,5,497538,242219,255319,kerala,KERALA
2013-14,7,513400,250554,262846,kerala,KERALA
2013-14,6,524124,254449,269675,kerala,KERALA
2013-14,8,555588,270826,284762,kerala,KERALA
2016-17,1,872,431,441,lakshadweep,LAKSHADWEEP
2016-17,2,983,434,549,lakshadweep,LAKSHADWEEP
2016-17,3,818,403,415,lakshadweep,LAKSHADWEEP
2016-17,4,536,266,270,lakshadweep,LAKSHADWEEP
2016-17,5,973,486,487,lakshadweep,LAKSHADWEEP
2016-17,6,1054,539,515,lakshadweep,LAKSHADWEEP
2016-17,7,1018,507,511,lakshadweep,LAKSHADWEEP
2016-17,8,1024,524,500,lakshadweep,LAKSHADWEEP
2015-16,1,927,410,517,lakshadweep,LAKSHADWEEP
2015-16,2,836,404,432,lakshadweep,LAKSHADWEEP
2015-16,3,561,280,281,lakshadweep,LAKSHADWEEP
2015-16,4,988,500,488,lakshadweep,LAKSHADWEEP
2015-16,5,1096,547,549,lakshadweep,LAKSHADWEEP
2015-16,6,1059,506,553,lakshadweep,LAKSHADWEEP
2015-16,7,1021,510,511,lakshadweep,LAKSHADWEEP
2015-16,8,1088,567,521,lakshadweep,LAKSHADWEEP
2014-15,1,766,378,388,lakshadweep,LAKSHADWEEP
2014-15,2,539,268,271,lakshadweep,LAKSHADWEEP
2014-15,3,999,502,497,lakshadweep,LAKSHADWEEP
2014-15,4,1116,549,567,lakshadweep,LAKSHADWEEP
2014-15,5,1089,521,568,lakshadweep,LAKSHADWEEP
2014-15,6,1059,537,522,lakshadweep,LAKSHADWEEP
2014-15,7,1118,570,548,lakshadweep,LAKSHADWEEP
2014-15,8,1202,625,577,lakshadweep,LAKSHADWEEP
2013-14,1,438,217,221,lakshadweep,LAKSHADWEEP
2013-14,2,993,500,493,lakshadweep,LAKSHADWEEP
2013-14,3,1106,538,568,lakshadweep,LAKSHADWEEP
2013-14,4,1074,499,575,lakshadweep,LAKSHADWEEP
2013-14,5,1080,512,568,lakshadweep,LAKSHADWEEP
2013-14,6,1168,607,561,lakshadweep,LAKSHADWEEP
2013-14,7,1190,615,575,lakshadweep,LAKSHADWEEP
2013-14,8,1240,656,584,lakshadweep,LAKSHADWEEP
2016-17,1,1606465,763653,842812,madhya pradesh,MADHYA PRADESH
2016-17,2,1538933,730464,808469,madhya pradesh,MADHYA PRADESH
2016-17,3,1583921,753638,830283,madhya pradesh,MADHYA PRADESH
2016-17,4,1578554,751419,827135,madhya pradesh,MADHYA PRADESH
2016-17,5,1601683,755720,845963,madhya pradesh,MADHYA PRADESH
2016-17,6,1431967,669843,762124,madhya pradesh,MADHYA PRADESH
2016-17,7,1530256,727919,802337,madhya pradesh,MADHYA PRADESH
2016-17,8,1514929,730300,784629,madhya pradesh,MADHYA PRADESH
2015-16,1,1609696,759735,849961,madhya pradesh,MADHYA PRADESH
2015-16,2,1631813,776327,855486,madhya pradesh,MADHYA PRADESH
2015-16,3,1631710,775925,855785,madhya pradesh,MADHYA PRADESH
2015-16,4,1657569,784007,873562,madhya pradesh,MADHYA PRADESH
2015-16,5,1580068,740107,839961,madhya pradesh,MADHYA PRADESH
2015-16,6,1595797,757697,838100,madhya pradesh,MADHYA PRADESH
2015-16,7,1583941,764392,819549,madhya pradesh,MADHYA PRADESH
2015-16,8,1511375,741139,770236,madhya pradesh,MADHYA PRADESH
2014-15,1,1755605,831201,924404,madhya pradesh,MADHYA PRADESH
2014-15,2,1723436,819471,903965,madhya pradesh,MADHYA PRADESH
2014-15,3,1751595,828915,922680,madhya pradesh,MADHYA PRADESH
2014-15,4,1662346,781841,880505,madhya pradesh,MADHYA PRADESH
2014-15,5,1786703,853872,932831,madhya pradesh,MADHYA PRADESH
2014-15,6,1663420,803453,859967,madhya pradesh,MADHYA PRADESH
2014-15,7,1597879,785825,812054,madhya pradesh,MADHYA PRADESH
2014-15,8,1561485,764401,797084,madhya pradesh,MADHYA PRADESH
2013-14,1,1943370,920792,1022578,madhya pradesh,MADHYA PRADESH
2013-14,2,1923371,910172,1013199,madhya pradesh,MADHYA PRADESH
2013-14,3,1823421,860660,962761,madhya pradesh,MADHYA PRADESH
2013-14,4,1953798,939903,1013895,madhya pradesh,MADHYA PRADESH
2013-14,5,1925046,936413,988633,madhya pradesh,MADHYA PRADESH
2013-14,6,1730433,855495,874938,madhya pradesh,MADHYA PRADESH
2013-14,7,1688166,832676,855490,madhya pradesh,MADHYA PRADESH
2013-14,8,1606484,797363,809121,madhya pradesh,MADHYA PRADESH
2016-17,1,2019316,940902,1078414,maharashtra,MAHARASHTRA
2016-17,2,2023723,944348,1079375,maharashtra,MAHARASHTRA
2016-17,3,2006519,943235,1063284,maharashtra,MAHARASHTRA
2016-17,4,1981394,931910,1049484,maharashtra,MAHARASHTRA
2016-17,5,1971157,926890,1044267,maharashtra,MAHARASHTRA
2016-17,6,1973924,925431,1048493,maharashtra,MAHARASHTRA
2016-17,7,2001262,940556,1060706,maharashtra,MAHARASHTRA
2016-17,8,2008417,936695,1071722,maharashtra,MAHARASHTRA
2015-16,1,2039892,950710,1089182,maharashtra,MAHARASHTRA
2015-16,2,2017288,948262,1069026,maharashtra,MAHARASHTRA
2015-16,3,1992588,937904,1054684,maharashtra,MAHARASHTRA
2015-16,4,1987687,936237,1051450,maharashtra,MAHARASHTRA
2015-16,5,1989047,933716,1055331,maharashtra,MAHARASHTRA
2015-16,6,2011728,946222,1065506,maharashtra,MAHARASHTRA
2015-16,7,2044326,957967,1086359,maharashtra,MAHARASHTRA
2015-16,8,1961219,908243,1052976,maharashtra,MAHARASHTRA
2014-15,1,2057635,965182,1092453,maharashtra,MAHARASHTRA
2014-15,2,2016259,948041,1068218,maharashtra,MAHARASHTRA
2014-15,3,2004971,944989,1059982,maharashtra,MAHARASHTRA
2014-15,4,2008888,944905,1063983,maharashtra,MAHARASHTRA
2014-15,5,2037963,959108,1078855,maharashtra,MAHARASHTRA
2014-15,6,2064742,968666,1096076,maharashtra,MAHARASHTRA
2014-15,7,2025165,943995,1081170,maharashtra,MAHARASHTRA
2014-15,8,1956811,901532,1055279,maharashtra,MAHARASHTRA
2013-14,1,2034182,954260,1079922,maharashtra,MAHARASHTRA
2013-14,3,2013473,948680,1064793,maharashtra,MAHARASHTRA
2013-14,4,2016058,949015,1067043,maharashtra,MAHARASHTRA
2013-14,5,2053712,968888,1084824,maharashtra,MAHARASHTRA
2013-14,7,2071384,973127,1098257,maharashtra,MAHARASHTRA
2013-14,6,2027838,946661,1081177,maharashtra,MAHARASHTRA
2013-14,8,1933584,892763,1040821,maharashtra,MAHARASHTRA
2016-17,1,80990,39409,41581,manipur,MANIPUR
2016-17,2,65826,32100,33726,manipur,MANIPUR
2016-17,3,59697,28715,30982,manipur,MANIPUR
2016-17,4,56855,27747,29108,manipur,MANIPUR
2016-17,5,54821,26648,28173,manipur,MANIPUR
2016-17,6,49460,24471,24989,manipur,MANIPUR
2016-17,7,46813,23386,23427,manipur,MANIPUR
2016-17,8,48146,24010,24136,manipur,MANIPUR
2015-16,1,79530,39543,39987,manipur,MANIPUR
2015-16,2,74901,36913,37988,manipur,MANIPUR
2015-16,3,67455,33204,34251,manipur,MANIPUR
2015-16,4,62923,31041,31882,manipur,MANIPUR
2015-16,5,60511,29847,30664,manipur,MANIPUR
2015-16,6,54595,26883,27712,manipur,MANIPUR
2015-16,7,51972,26156,25816,manipur,MANIPUR
2015-16,8,50709,25097,25612,manipur,MANIPUR
2014-15,1,84014,41746,42268,manipur,MANIPUR
2014-15,2,76650,37688,38962,manipur,MANIPUR
2014-15,3,67744,33554,34190,manipur,MANIPUR
2014-15,4,62642,30825,31817,manipur,MANIPUR
2014-15,5,64247,31619,32628,manipur,MANIPUR
2014-15,6,52199,26163,26036,manipur,MANIPUR
2014-15,7,50941,25535,25406,manipur,MANIPUR
2014-15,8,49619,24807,24812,manipur,MANIPUR
2013-14,1,100336,49614,50722,manipur,MANIPUR
2013-14,2,90547,45195,45352,manipur,MANIPUR
2013-14,3,75282,38029,37253,manipur,MANIPUR
2013-14,4,67283,33330,33953,manipur,MANIPUR
2013-14,5,61671,30864,30807,manipur,MANIPUR
2013-14,6,54852,27569,27283,manipur,MANIPUR
2013-14,7,49785,24443,25342,manipur,MANIPUR
2013-14,8,50141,24560,25581,manipur,MANIPUR
2016-17,1,132158,64289,67869,meghalaya,MEGHALAYA
2016-17,2,103310,50438,52872,meghalaya,MEGHALAYA
2016-17,3,97600,47944,49656,meghalaya,MEGHALAYA
2016-17,4,88892,44742,44150,meghalaya,MEGHALAYA
2016-17,5,79793,40529,39264,meghalaya,MEGHALAYA
2016-17,6,79942,41569,38373,meghalaya,MEGHALAYA
2016-17,7,70692,37306,33386,meghalaya,MEGHALAYA
2016-17,8,64076,33917,30159,meghalaya,MEGHALAYA
2015-16,1,144376,70941,73435,meghalaya,MEGHALAYA
2015-16,2,114045,56087,57958,meghalaya,MEGHALAYA
2015-16,3,107046,53391,53655,meghalaya,MEGHALAYA
2015-16,4,96304,48690,47614,meghalaya,MEGHALAYA
2015-16,5,85959,44089,41870,meghalaya,MEGHALAYA
2015-16,6,83950,43739,40211,meghalaya,MEGHALAYA
2015-16,7,74869,39616,35253,meghalaya,MEGHALAYA
2015-16,8,69064,36740,32324,meghalaya,MEGHALAYA
2014-15,1,144576,70717,73859,meghalaya,MEGHALAYA
2014-15,2,113129,55911,57218,meghalaya,MEGHALAYA
2014-15,3,105168,52354,52814,meghalaya,MEGHALAYA
2014-15,4,94163,47696,46467,meghalaya,MEGHALAYA
2014-15,5,82049,42534,39515,meghalaya,MEGHALAYA
2014-15,6,79798,41686,38112,meghalaya,MEGHALAYA
2014-15,7,71536,37922,33614,meghalaya,MEGHALAYA
2014-15,8,66036,34987,31049,meghalaya,MEGHALAYA
2013-14,1,145085,71232,73853,meghalaya,MEGHALAYA
2013-14,2,111832,55315,56517,meghalaya,MEGHALAYA
2013-14,3,103175,51484,51691,meghalaya,MEGHALAYA
2013-14,4,89885,45855,44030,meghalaya,MEGHALAYA
2013-14,5,78217,40609,37608,meghalaya,MEGHALAYA
2013-14,6,77103,40674,36429,meghalaya,MEGHALAYA
2013-14,7,69317,36850,32467,meghalaya,MEGHALAYA
2013-14,8,63510,34064,29446,meghalaya,MEGHALAYA
2016-17,1,36006,17365,18641,mizoram,MIZORAM
2016-17,2,27561,13351,14210,mizoram,MIZORAM
2016-17,3,25893,12512,13381,mizoram,MIZORAM
2016-17,4,24036,11472,12564,mizoram,MIZORAM
2016-17,5,23180,11078,12102,mizoram,MIZORAM
2016-17,6,22248,10792,11456,mizoram,MIZORAM
2016-17,7,22242,10710,11532,mizoram,MIZORAM
2016-17,8,20780,9990,10790,mizoram,MIZORAM
2015-16,1,39096,18861,20235,mizoram,MIZORAM
2015-16,2,29366,14226,15140,mizoram,MIZORAM
2015-16,3,27227,13110,14117,mizoram,MIZORAM
2015-16,4,25351,12154,13197,mizoram,MIZORAM
2015-16,5,24277,11744,12533,mizoram,MIZORAM
2015-16,6,24198,11634,12564,mizoram,MIZORAM
2015-16,7,23243,11238,12005,mizoram,MIZORAM
2015-16,8,21559,10296,11263,mizoram,MIZORAM
2014-15,1,39724,19128,20596,mizoram,MIZORAM
2014-15,2,28683,13771,14912,mizoram,MIZORAM
2014-15,3,26461,12766,13695,mizoram,MIZORAM
2014-15,4,25207,12209,12998,mizoram,MIZORAM
2014-15,5,25135,12068,13067,mizoram,MIZORAM
2014-15,6,24237,11550,12687,mizoram,MIZORAM
2014-15,7,22945,11017,11928,mizoram,MIZORAM
2014-15,8,21783,10711,11072,mizoram,MIZORAM
2013-14,1,40138,19540,20598,mizoram,MIZORAM
2013-14,2,29536,14204,15332,mizoram,MIZORAM
2013-14,3,28141,13727,14414,mizoram,MIZORAM
2013-14,4,26224,12571,13653,mizoram,MIZORAM
2013-14,5,25362,12119,13243,mizoram,MIZORAM
2013-14,6,24246,11629,12617,mizoram,MIZORAM
2013-14,7,23691,11548,12143,mizoram,MIZORAM
2013-14,8,20625,9994,10631,mizoram,MIZORAM
2016-17,1,42112,20786,21326,nagaland,NAGALAND
2016-17,2,40511,19550,20961,nagaland,NAGALAND
2016-17,3,39295,19005,20290,nagaland,NAGALAND
2016-17,4,37737,18390,19347,nagaland,NAGALAND
2016-17,5,35770,17375,18395,nagaland,NAGALAND
2016-17,6,35081,17048,18033,nagaland,NAGALAND
2016-17,7,33291,16615,16676,nagaland,NAGALAND
2016-17,8,30321,14915,15406,nagaland,NAGALAND
2015-16,1,50830,24558,26272,nagaland,NAGALAND
2015-16,2,49480,24307,25173,nagaland,NAGALAND
2015-16,3,47835,23444,24391,nagaland,NAGALAND
2015-16,4,47031,23088,23943,nagaland,NAGALAND
2015-16,5,42904,20864,22040,nagaland,NAGALAND
2015-16,6,40025,19899,20126,nagaland,NAGALAND
2015-16,7,37150,18345,18805,nagaland,NAGALAND
2015-16,8,34441,16955,17486,nagaland,NAGALAND
2014-15,1,52100,25361,26739,nagaland,NAGALAND
2014-15,2,49079,23935,25144,nagaland,NAGALAND
2014-15,3,48446,23634,24812,nagaland,NAGALAND
2014-15,4,45948,22201,23747,nagaland,NAGALAND
2014-15,5,45530,22506,23024,nagaland,NAGALAND
2014-15,6,40591,19987,20604,nagaland,NAGALAND
2014-15,7,37409,18514,18895,nagaland,NAGALAND
2014-15,8,35207,17458,17749,nagaland,NAGALAND
2013-14,1,59262,29041,30221,nagaland,NAGALAND
2013-14,2,60549,29834,30715,nagaland,NAGALAND
2013-14,3,58372,28573,29799,nagaland,NAGALAND
2013-14,4,56211,27650,28561,nagaland,NAGALAND
2013-14,5,50904,24967,25937,nagaland,NAGALAND
2013-14,6,44526,21906,22620,nagaland,NAGALAND
2013-14,7,42698,21191,21507,nagaland,NAGALAND
2013-14,8,39173,19535,19638,nagaland,NAGALAND
2016-17,1,798665,387119,411546,odisha,ODISHA
2016-17,2,774477,375375,399102,odisha,ODISHA
2016-17,3,795513,384994,410519,odisha,ODISHA
2016-17,4,792430,382059,410371,odisha,ODISHA
2016-17,5,810939,389913,421026,odisha,ODISHA
2016-17,6,762019,365719,396300,odisha,ODISHA
2016-17,7,761954,365387,396567,odisha,ODISHA
2016-17,8,702028,339575,362453,odisha,ODISHA
2015-16,1,794572,384212,410360,odisha,ODISHA
2015-16,2,817755,396692,421063,odisha,ODISHA
2015-16,3,821088,397586,423502,odisha,ODISHA
2015-16,4,837053,403289,433764,odisha,ODISHA
2015-16,5,840582,405124,435458,odisha,ODISHA
2015-16,6,784548,377767,406781,odisha,ODISHA
2015-16,7,730622,352035,378587,odisha,ODISHA
2015-16,8,701864,341677,360187,odisha,ODISHA
2014-15,1,821047,397042,424005,odisha,ODISHA
2014-15,2,829762,401291,428471,odisha,ODISHA
2014-15,3,855534,412481,443053,odisha,ODISHA
2014-15,4,858503,414115,444388,odisha,ODISHA
2014-15,5,858782,413545,445237,odisha,ODISHA
2014-15,6,744203,358936,385267,odisha,ODISHA
2014-15,7,720385,348748,371637,odisha,ODISHA
2014-15,8,698267,343160,355107,odisha,ODISHA
2013-14,1,840354,405878,434476,odisha,ODISHA
2013-14,2,867646,419239,448407,odisha,ODISHA
2013-14,3,880196,425132,455064,odisha,ODISHA
2013-14,4,875874,422499,453375,odisha,ODISHA
2013-14,5,813640,393062,420578,odisha,ODISHA
2013-14,6,731234,354477,376757,odisha,ODISHA
2013-14,7,715112,350146,364966,odisha,ODISHA
2013-14,8,664001,324584,339417,odisha,ODISHA
2016-17,1,20662,9947,10715,puducherry,PUDUCHERRY
2016-17,2,21158,10181,10977,puducherry,PUDUCHERRY
2016-17,3,20973,10097,10876,puducherry,PUDUCHERRY
2016-17,4,21050,10180,10870,puducherry,PUDUCHERRY
2016-17,5,21151,10285,10866,puducherry,PUDUCHERRY
2016-17,6,21012,10200,10812,puducherry,PUDUCHERRY
2016-17,7,21717,10519,11198,puducherry,PUDUCHERRY
2016-17,8,21008,10185,10823,puducherry,PUDUCHERRY
2015-16,1,20770,10067,10703,puducherry,PUDUCHERRY
2015-16,2,20773,10010,10763,puducherry,PUDUCHERRY
2015-16,3,20894,10159,10735,puducherry,PUDUCHERRY
2015-16,4,21164,10410,10754,puducherry,PUDUCHERRY
2015-16,5,20431,9988,10443,puducherry,PUDUCHERRY
2015-16,6,21788,10576,11212,puducherry,PUDUCHERRY
2015-16,7,21435,10423,11012,puducherry,PUDUCHERRY
2015-16,8,22207,10707,11500,puducherry,PUDUCHERRY
2014-15,1,21011,10145,10866,puducherry,PUDUCHERRY
2014-15,2,20935,10198,10737,puducherry,PUDUCHERRY
2014-15,3,21239,10412,10827,puducherry,PUDUCHERRY
2014-15,4,20554,10066,10488,puducherry,PUDUCHERRY
2014-15,5,21704,10518,11186,puducherry,PUDUCHERRY
2014-15,6,21509,10456,11053,puducherry,PUDUCHERRY
2014-15,7,22365,10815,11550,puducherry,PUDUCHERRY
2014-15,8,22249,10654,11595,puducherry,PUDUCHERRY
2013-14,1,21068,10182,10886,puducherry,PUDUCHERRY
2013-14,2,21401,10454,10947,puducherry,PUDUCHERRY
2013-14,3,20788,10161,10627,puducherry,PUDUCHERRY
2013-14,4,21927,10674,11253,puducherry,PUDUCHERRY
2013-14,5,21513,10489,11024,puducherry,PUDUCHERRY
2013-14,6,22506,10836,11670,puducherry,PUDUCHERRY
2013-14,7,22439,10752,11687,puducherry,PUDUCHERRY
2013-14,8,22480,11121,11359,puducherry,PUDUCHERRY
2016-17,1,492204,225339,266865,punjab,PUNJAB
2016-17,2,492003,225317,266686,punjab,PUNJAB
2016-17,3,487318,222517,264801,punjab,PUNJAB
2016-17,4,473939,215165,258774,punjab,PUNJAB
2016-17,5,484801,220337,264464,punjab,PUNJAB
2016-17,6,480094,216117,263977,punjab,PUNJAB
2016-17,7,503693,227120,276573,punjab,PUNJAB
2016-17,8,480176,216089,264087,punjab,PUNJAB
2015-16,1,510094,232771,277323,punjab,PUNJAB
2015-16,2,499386,227494,271892,punjab,PUNJAB
2015-16,3,485786,220161,265625,punjab,PUNJAB
2015-16,4,492495,223438,269057,punjab,PUNJAB
2015-16,5,500822,225372,275450,punjab,PUNJAB
2015-16,6,510822,229697,281125,punjab,PUNJAB
2015-16,7,489085,219214,269871,punjab,PUNJAB
2015-16,8,473949,209017,264932,punjab,PUNJAB
2014-15,1,523720,238894,284826,punjab,PUNJAB
2014-15,2,496053,225234,270819,punjab,PUNJAB
2014-15,3,506572,230618,275954,punjab,PUNJAB
2014-15,4,506219,228373,277846,punjab,PUNJAB
2014-15,5,535492,241095,294397,punjab,PUNJAB
2014-15,6,498192,223559,274633,punjab,PUNJAB
2014-15,7,481982,213015,268967,punjab,PUNJAB
2014-15,8,473349,206611,266738,punjab,PUNJAB
2013-14,1,512713,231976,280737,punjab,PUNJAB
2013-14,2,506747,230350,276397,punjab,PUNJAB
2013-14,3,511075,230466,280609,punjab,PUNJAB
2013-14,4,532555,239977,292578,punjab,PUNJAB
2013-14,5,512790,230261,282529,punjab,PUNJAB
2013-14,6,489086,215862,273224,punjab,PUNJAB
2013-14,7,476657,208765,267892,punjab,PUNJAB
2013-14,8,469897,207087,262810,punjab,PUNJAB
2016-17,1,1766855,821479,945376,rajasthan,RAJASTHAN
2016-17,2,1781981,839572,942409,rajasthan,RAJASTHAN
2016-17,3,1584284,739534,844750,rajasthan,RAJASTHAN
2016-17,4,1476121,685087,791034,rajasthan,RAJASTHAN
2016-17,5,1447581,667062,780519,rajasthan,RAJASTHAN
2016-17,6,1391713,635937,755776,rajasthan,RAJASTHAN
2016-17,7,1414575,648100,766475,rajasthan,RAJASTHAN
2016-17,8,1288995,581190,707805,rajasthan,RAJASTHAN
2015-16,1,2033407,949701,1083706,rajasthan,RAJASTHAN
2015-16,2,1675484,781820,893664,rajasthan,RAJASTHAN
2015-16,3,1559013,724791,834222,rajasthan,RAJASTHAN
2015-16,4,1493550,691883,801667,rajasthan,RAJASTHAN
2015-16,5,1512155,696821,815334,rajasthan,RAJASTHAN
2015-16,6,1473184,677743,795441,rajasthan,RAJASTHAN
2015-16,7,1334366,602658,731708,rajasthan,RAJASTHAN
2015-16,8,1258976,562444,696532,rajasthan,RAJASTHAN
2014-15,1,1843149,848266,994883,rajasthan,RAJASTHAN
2014-15,2,1617063,749905,867158,rajasthan,RAJASTHAN
2014-15,3,1560544,725077,835467,rajasthan,RAJASTHAN
2014-15,4,1530229,709164,821065,rajasthan,RAJASTHAN
2014-15,5,1589881,739452,850429,rajasthan,RAJASTHAN
2014-15,6,1372087,620585,751502,rajasthan,RAJASTHAN
2014-15,7,1288305,574600,713705,rajasthan,RAJASTHAN
2014-15,8,1224944,541498,683446,rajasthan,RAJASTHAN
2013-14,1,1803858,828053,975805,rajasthan,RAJASTHAN
2013-14,2,1696301,790838,905463,rajasthan,RAJASTHAN
2013-14,3,1667451,782344,885107,rajasthan,RAJASTHAN
2013-14,4,1680712,792784,887928,rajasthan,RAJASTHAN
2013-14,5,1545765,716448,829317,rajasthan,RAJASTHAN
2013-14,6,1357448,611950,745498,rajasthan,RAJASTHAN
2013-14,7,1281020,571639,709381,rajasthan,RAJASTHAN
2013-14,8,1257697,555965,701732,rajasthan,RAJASTHAN
2016-17,1,9589,4497,5092,sikkim,SIKKIM
2016-17,2,10344,4850,5494,sikkim,SIKKIM
2016-17,3,10678,4941,5737,sikkim,SIKKIM
2016-17,4,11335,5345,5990,sikkim,SIKKIM
2016-17,5,12429,5870,6559,sikkim,SIKKIM
2016-17,6,13062,6478,6584,sikkim,SIKKIM
2016-17,7,14255,7226,7029,sikkim,SIKKIM
2016-17,8,13089,6744,6345,sikkim,SIKKIM
2015-16,1,11498,5312,6186,sikkim,SIKKIM
2015-16,2,10833,4998,5835,sikkim,SIKKIM
2015-16,3,11558,5451,6107,sikkim,SIKKIM
2015-16,4,12932,6088,6844,sikkim,SIKKIM
2015-16,5,13986,6759,7227,sikkim,SIKKIM
2015-16,6,15826,8010,7816,sikkim,SIKKIM
2015-16,7,14344,7393,6951,sikkim,SIKKIM
2015-16,8,14320,7340,6980,sikkim,SIKKIM
2014-15,1,11058,5025,6033,sikkim,SIKKIM
2014-15,2,11525,5401,6124,sikkim,SIKKIM
2014-15,3,13021,6107,6914,sikkim,SIKKIM
2014-15,4,14105,6778,7327,sikkim,SIKKIM
2014-15,5,16963,8203,8760,sikkim,SIKKIM
2014-15,6,14796,7536,7260,sikkim,SIKKIM
2014-15,7,14624,7403,7221,sikkim,SIKKIM
2014-15,8,14716,7701,7015,sikkim,SIKKIM
2013-14,1,12077,5567,6510,sikkim,SIKKIM
2013-14,2,13531,6285,7246,sikkim,SIKKIM
2013-14,3,14693,7043,7650,sikkim,SIKKIM
2013-14,4,17636,8533,9103,sikkim,SIKKIM
2013-14,5,15895,7823,8072,sikkim,SIKKIM
2013-14,6,15821,7926,7895,sikkim,SIKKIM
2013-14,7,15396,7869,7527,sikkim,SIKKIM
2013-14,8,15052,7853,7199,sikkim,SIKKIM
2016-17,1,1084789,526455,558334,tamil nadu,TAMIL NADU
2016-17,2,1097203,530301,566902,tamil nadu,TAMIL NADU
2016-17,3,1157738,563004,594734,tamil nadu,TAMIL NADU
2016-17,4,1153095,561604,591491,tamil nadu,TAMIL NADU
2016-17,5,1153153,559651,593502,tamil nadu,TAMIL NADU
2016-17,6,1162769,567844,594925,tamil nadu,TAMIL NADU
2016-17,7,1126697,549145,577552,tamil nadu,TAMIL NADU
2016-17,8,1173448,572455,600993,tamil nadu,TAMIL NADU
2015-16,1,1099563,534262,565301,tamil nadu,TAMIL NADU
2015-16,2,1161177,565207,595970,tamil nadu,TAMIL NADU
2015-16,3,1154983,566134,588849,tamil nadu,TAMIL NADU
2015-16,4,1155816,564232,591584,tamil nadu,TAMIL NADU
2015-16,5,1178820,575471,603349,tamil nadu,TAMIL NADU
2015-16,6,1127198,549059,578139,tamil nadu,TAMIL NADU
2015-16,7,1182536,574969,607567,tamil nadu,TAMIL NADU
2015-16,8,1176099,574196,601903,tamil nadu,TAMIL NADU
2014-15,1,1161012,566937,594075,tamil nadu,TAMIL NADU
2014-15,2,1136010,553478,582532,tamil nadu,TAMIL NADU
2014-15,3,1134718,553377,581341,tamil nadu,TAMIL NADU
2014-15,4,1138573,554338,584235,tamil nadu,TAMIL NADU
2014-15,5,1183421,574656,608765,tamil nadu,TAMIL NADU
2014-15,6,1150908,560832,590076,tamil nadu,TAMIL NADU
2014-15,7,1157542,564038,593504,tamil nadu,TAMIL NADU
2014-15,8,1190283,578005,612278,tamil nadu,TAMIL NADU
2013-14,1,1169855,569502,600353,tamil nadu,TAMIL NADU
2013-14,3,1131279,550861,580418,tamil nadu,TAMIL NADU
2013-14,4,1133013,551291,581722,tamil nadu,TAMIL NADU
2013-14,5,1160886,564714,596172,tamil nadu,TAMIL NADU
2013-14,7,1174652,570626,604026,tamil nadu,TAMIL NADU
2013-14,6,1177180,574670,602510,tamil nadu,TAMIL NADU
2013-14,8,1243868,604365,639503,tamil nadu,TAMIL NADU
2016-17,1,689333,329224,360109,telangana,TELANGANA
2016-17,2,628931,302112,326819,telangana,TELANGANA
2016-17,3,605083,291080,314003,telangana,TELANGANA
2016-17,4,591778,285491,306287,telangana,TELANGANA
2016-17,5,593868,286932,306936,telangana,TELANGANA
2016-17,6,576612,278928,297684,telangana,TELANGANA
2016-17,7,580114,281867,298247,telangana,TELANGANA
2016-17,8,552253,270924,281329,telangana,TELANGANA
2015-16,1,727048,347444,379604,telangana,TELANGANA
2015-16,2,643693,310692,333001,telangana,TELANGANA
2015-16,3,632494,306582,325912,telangana,TELANGANA
2015-16,4,620796,301034,319762,telangana,TELANGANA
2015-16,5,622945,302320,320625,telangana,TELANGANA
2015-16,6,605188,294714,310474,telangana,TELANGANA
2015-16,7,596679,291984,304695,telangana,TELANGANA
2015-16,8,556342,273551,282791,telangana,TELANGANA
2014-15,1,704558,337353,367205,telangana,TELANGANA
2014-15,2,629385,305063,324322,telangana,TELANGANA
2014-15,3,625246,303199,322047,telangana,TELANGANA
2014-15,4,616023,300598,315425,telangana,TELANGANA
2014-15,5,616361,299129,317232,telangana,TELANGANA
2014-15,6,594142,291196,302946,telangana,TELANGANA
2014-15,7,583034,285573,297461,telangana,TELANGANA
2014-15,8,550441,270939,279502,telangana,TELANGANA
2016-17,1,67535,33430,34105,tripura,TRIPURA
2016-17,2,65473,31827,33646,tripura,TRIPURA
2016-17,3,70944,34454,36490,tripura,TRIPURA
2016-17,4,70754,34619,36135,tripura,TRIPURA
2016-17,5,73213,35878,37335,tripura,TRIPURA
2016-17,6,70012,34414,35598,tripura,TRIPURA
2016-17,7,65913,32550,33363,tripura,TRIPURA
2016-17,8,64231,31977,32254,tripura,TRIPURA
2015-16,1,66630,32290,34340,tripura,TRIPURA
2015-16,2,72905,35533,37372,tripura,TRIPURA
2015-16,3,73739,36147,37592,tripura,TRIPURA
2015-16,4,76296,37380,38916,tripura,TRIPURA
2015-16,5,77298,37972,39326,tripura,TRIPURA
2015-16,6,69427,34083,35344,tripura,TRIPURA
2015-16,7,68149,33694,34455,tripura,TRIPURA
2015-16,8,65068,32223,32845,tripura,TRIPURA
2014-15,1,72282,35197,37085,tripura,TRIPURA
2014-15,2,72772,35623,37149,tripura,TRIPURA
2014-15,3,76356,37379,38977,tripura,TRIPURA
2014-15,4,77802,38028,39774,tripura,TRIPURA
2014-15,5,75250,37063,38187,tripura,TRIPURA
2014-15,6,69950,34478,35472,tripura,TRIPURA
2014-15,7,66716,32780,33936,tripura,TRIPURA
2014-15,8,66087,32662,33425,tripura,TRIPURA
2013-14,1,73712,36178,37534,tripura,TRIPURA
2013-14,2,77657,38059,39598,tripura,TRIPURA
2013-14,3,80556,39333,41223,tripura,TRIPURA
2013-14,4,77383,37938,39445,tripura,TRIPURA
2013-14,5,77222,37974,39248,tripura,TRIPURA
2013-14,6,69519,34071,35448,tripura,TRIPURA
2013-14,7,68637,33591,35046,tripura,TRIPURA
2013-14,8,65544,32145,33399,tripura,TRIPURA
2016-17,1,5074511,2453762,2620749,uttar pradesh,UTTAR PRADESH
2016-17,2,4830100,2353167,2476933,uttar pradesh,UTTAR PRADESH
2016-17,3,4780351,2333921,2446430,uttar pradesh,UTTAR PRADESH
2016-17,4,4702665,2299987,2402678,uttar pradesh,UTTAR PRADESH
2016-17,5,4512275,2212416,2299859,uttar pradesh,UTTAR PRADESH
2016-17,6,3615913,1792000,1823913,uttar pradesh,UTTAR PRADESH
2016-17,7,3590878,1785749,1805129,uttar pradesh,UTTAR PRADESH
2016-17,8,3601052,1794526,1806526,uttar pradesh,UTTAR PRADESH
2015-16,1,5394236,2611362,2782874,uttar pradesh,UTTAR PRADESH
2015-16,2,5079671,2471344,2608327,uttar pradesh,UTTAR PRADESH
2015-16,3,5185980,2530200,2655780,uttar pradesh,UTTAR PRADESH
2015-16,4,4987821,2449702,2538119,uttar pradesh,UTTAR PRADESH
2015-16,5,4622640,2272133,2350507,uttar pradesh,UTTAR PRADESH
2015-16,6,3716794,1851712,1865082,uttar pradesh,UTTAR PRADESH
2015-16,7,3705696,1847648,1858048,uttar pradesh,UTTAR PRADESH
2015-16,8,3732795,1861296,1871499,uttar pradesh,UTTAR PRADESH
2014-15,1,5375448,2597285,2778163,uttar pradesh,UTTAR PRADESH
2014-15,2,5388971,2613679,2775292,uttar pradesh,UTTAR PRADESH
2014-15,3,5386110,2632356,2753754,uttar pradesh,UTTAR PRADESH
2014-15,4,4976152,2445458,2530694,uttar pradesh,UTTAR PRADESH
2014-15,5,4680248,2298767,2381481,uttar pradesh,UTTAR PRADESH
2014-15,6,3663773,1827960,1835813,uttar pradesh,UTTAR PRADESH
2014-15,7,3675032,1831108,1843924,uttar pradesh,UTTAR PRADESH
2014-15,8,3692986,1855617,1837369,uttar pradesh,UTTAR PRADESH
2013-14,1,5653503,2701380,2952123,uttar pradesh,UTTAR PRADESH
2013-14,2,5510136,2671295,2838841,uttar pradesh,UTTAR PRADESH
2013-14,3,5244370,2558994,2685376,uttar pradesh,UTTAR PRADESH
2013-14,4,4897667,2399241,2498426,uttar pradesh,UTTAR PRADESH
2013-14,5,4635910,2274068,2361842,uttar pradesh,UTTAR PRADESH
2013-14,6,3637921,1804860,1833061,uttar pradesh,UTTAR PRADESH
2013-14,7,3593779,1796993,1796786,uttar pradesh,UTTAR PRADESH
2013-14,8,3553214,1800634,1752580,uttar pradesh,UTTAR PRADESH
2016-17,1,231368,107704,123664,uttarakhand,UTTARAKHAND
2016-17,2,217826,102393,115433,uttarakhand,UTTARAKHAND
2016-17,3,213970,100809,113161,uttarakhand,UTTARAKHAND
2016-17,4,210652,99533,111119,uttarakhand,UTTARAKHAND
2016-17,5,209098,98884,110214,uttarakhand,UTTARAKHAND
2016-17,6,200755,95402,105353,uttarakhand,UTTARAKHAND
2016-17,7,199709,95212,104497,uttarakhand,UTTARAKHAND
2016-17,8,195917,93686,102231,uttarakhand,UTTARAKHAND
2015-16,1,241830,113062,128768,uttarakhand,UTTARAKHAND
2015-16,2,222672,104943,117729,uttarakhand,UTTARAKHAND
2015-16,3,220120,104058,116062,uttarakhand,UTTARAKHAND
2015-16,4,215768,102335,113433,uttarakhand,UTTARAKHAND
2015-16,5,214818,101755,113063,uttarakhand,UTTARAKHAND
2015-16,6,203359,96896,106463,uttarakhand,UTTARAKHAND
2015-16,7,198864,95073,103791,uttarakhand,UTTARAKHAND
2015-16,8,195242,93642,101600,uttarakhand,UTTARAKHAND
2014-15,1,238399,111394,127005,uttarakhand,UTTARAKHAND
2014-15,2,226227,106687,119540,uttarakhand,UTTARAKHAND
2014-15,3,223050,105586,117464,uttarakhand,UTTARAKHAND
2014-15,4,218822,103442,115380,uttarakhand,UTTARAKHAND
2014-15,5,216304,102732,113572,uttarakhand,UTTARAKHAND
2014-15,6,197372,94576,102796,uttarakhand,UTTARAKHAND
2014-15,7,193393,92763,100630,uttarakhand,UTTARAKHAND
2014-15,8,193890,93524,100366,uttarakhand,UTTARAKHAND
2013-14,1,239191,112449,126742,uttarakhand,UTTARAKHAND
2013-14,2,224802,106126,118676,uttarakhand,UTTARAKHAND
2013-14,3,223511,105586,117925,uttarakhand,UTTARAKHAND
2013-14,4,218608,103786,114822,uttarakhand,UTTARAKHAND
2013-14,5,211011,100436,110575,uttarakhand,UTTARAKHAND
2013-14,6,194802,93189,101613,uttarakhand,UTTARAKHAND
2013-14,7,194478,93297,101181,uttarakhand,UTTARAKHAND
2013-14,8,198487,95925,102562,uttarakhand,UTTARAKHAND
2016-17,1,1602506,776625,825881,west bengal,WEST BENGAL
2016-17,2,1604574,779085,825489,west bengal,WEST BENGAL
2016-17,3,1569082,760972,808110,west bengal,WEST BENGAL
2016-17,4,1210705,570181,640524,west bengal,WEST BENGAL
2016-17,5,1563823,783207,780616,west bengal,WEST BENGAL
2016-17,6,1495642,759718,735924,west bengal,WEST BENGAL
2016-17,7,1444315,746755,697560,west bengal,WEST BENGAL
2016-17,8,1443375,759216,684159,west bengal,WEST BENGAL
2015-16,1,1695514,828335,867179,west bengal,WEST BENGAL
2015-16,2,1651050,805724,845326,west bengal,WEST BENGAL
2015-16,3,1232558,586723,645835,west bengal,WEST BENGAL
2015-16,4,1914146,939090,975056,west bengal,WEST BENGAL
2015-16,5,1638529,823264,815265,west bengal,WEST BENGAL
2015-16,6,1586394,805324,781070,west bengal,WEST BENGAL
2015-16,7,1589119,818868,770251,west bengal,WEST BENGAL
2015-16,8,1601724,842262,759462,west bengal,WEST BENGAL
2014-15,1,1639728,797898,841830,west bengal,WEST BENGAL
2014-15,2,1196294,567416,628878,west bengal,WEST BENGAL
2014-15,3,1878803,919584,959219,west bengal,WEST BENGAL
2014-15,4,1833628,903160,930468,west bengal,WEST BENGAL
2014-15,5,1614568,812953,801615,west bengal,WEST BENGAL
2014-15,6,1631486,830396,801090,west bengal,WEST BENGAL
2014-15,7,1651858,856537,795321,west bengal,WEST BENGAL
2014-15,8,1568742,826309,742433,west bengal,WEST BENGAL
2013-14,1,1207003,573560,633443,west bengal,WEST BENGAL
2013-14,2,1933086,944593,988493,west bengal,WEST BENGAL
2013-14,3,1832809,902718,930091,west bengal,WEST BENGAL
2013-14,4,1779022,878509,900513,west bengal,WEST BENGAL
2013-14,5,1685797,849956,835841,west bengal,WEST BENGAL
2013-14,6,1709110,875527,833583,west bengal,WEST BENGAL
2013-14,7,1620885,843385,777500,west bengal,WEST BENGAL
2013-14,8,1620885,797641,823244,west bengal,WEST BENGAL
