Year,grade,total,girls,boys,State
2016-17,8,6146,3020,3126,A & N ISLANDS
2016-17,9,6685,3106,3579,A & N ISLANDS
2016-17,10,5744,2861,2883,A & N ISLANDS
2016-17,11,6001,2898,3103,A & N ISLANDS
2016-17,12,4496,2429,2067,A & N ISLANDS
2015-16,8,6140,2980,3160,A & N ISLANDS
2015-16,9,6890,3240,3650,A & N ISLANDS
2015-16,10,5929,2948,2981,A & N ISLANDS
2015-16,11,5896,2895,3001,A & N ISLANDS
2015-16,12,4865,2492,2373,A & N ISLANDS
2014-15,8,6458,3158,3300,A & N ISLANDS
2014-15,9,7039,3255,3784,A & N ISLANDS
2014-15,10,5903,3028,2875,A & N ISLANDS
2014-15,11,6555,3054,3501,A & N ISLANDS
2014-15,12,5259,2601,2658,A & N ISLANDS
2013-14,8,6716,3245,3471,A & N ISLANDS
2013-14,9,6728,3296,3432,A & N ISLANDS
2013-14,10,6551,3161,3390,A & N ISLANDS
2013-14,11,6698,3049,3649,A & N ISLANDS
2013-14,12,5083,2558,2525,A & N ISLANDS
2016-17,8,690345,334787,355558,ANDHRA PRADESH
2016-17,9,651149,315623,335526,ANDHRA PRADESH
2016-17,10,635428,306039,329389,ANDHRA PRADESH
2016-17,11,0,0,0,ANDHRA PRADESH
2016-17,12,0,0,0,ANDHRA PRADESH
2015-16,8,664448,323072,341376,ANDHRA PRADESH
2015-16,9,643769,311772,331997,ANDHRA PRADESH
2015-16,10,629596,306223,323373,ANDHRA PRADESH
2015-16,11,445516,219927,225589,ANDHRA PRADESH
2015-16,12,491084,237311,253773,ANDHRA PRADESH
2014-15,8,681449,330754,350695,ANDHRA PRADESH
2014-15,9,654648,319883,334765,ANDHRA PRADESH
2014-15,10,621042,303605,317437,ANDHRA PRADESH
2014-15,11,434511,209868,224643,ANDHRA PRADESH
2014-15,12,387303,186133,201170,ANDHRA PRADESH
2013-14,8,1241936,613257,628679,ANDHRA PRADESH
2013-14,9,1171353,579966,591387,ANDHRA PRADESH
2013-14,10,1065150,522933,542217,ANDHRA PRADESH
2013-14,11,810332,393680,416652,ANDHRA PRADESH
2013-14,12,794214,385124,409090,ANDHRA PRADESH
2012-13,8,1214822,601821,613001,ANDHRA PRADESH
2012-13,9,1096495,541069,555426,ANDHRA PRADESH
2012-13,10,1047261,513090,534171,ANDHRA PRADESH
2012-13,11,797356,376754,420602,ANDHRA PRADESH
2012-13,12,691272,331838,359434,ANDHRA PRADESH
2016-17,8,29322,14867,14455,ARUNACHAL PRADESH
2016-17,9,28253,13610,14643,ARUNACHAL PRADESH
2016-17,10,23205,11512,11693,ARUNACHAL PRADESH
2016-17,11,14228,7087,7141,ARUNACHAL PRADESH
2016-17,12,14874,7534,7340,ARUNACHAL PRADESH
2015-16,8,32492,16252,16240,ARUNACHAL PRADESH
2015-16,9,29151,13959,15192,ARUNACHAL PRADESH
2015-16,10,24517,12024,12493,ARUNACHAL PRADESH
2015-16,11,19190,9479,9711,ARUNACHAL PRADESH
2015-16,12,15964,7918,8046,ARUNACHAL PRADESH
2014-15,8,32123,16022,16101,ARUNACHAL PRADESH
2014-15,9,29107,13887,15220,ARUNACHAL PRADESH
2014-15,10,23676,11649,12027,ARUNACHAL PRADESH
2014-15,11,19490,9571,9919,ARUNACHAL PRADESH
2014-15,12,15579,7696,7883,ARUNACHAL PRADESH
2013-14,8,31540,15807,15733,ARUNACHAL PRADESH
2013-14,9,27636,13257,14379,ARUNACHAL PRADESH
2013-14,10,23400,11212,12188,ARUNACHAL PRADESH
2013-14,11,18308,8901,9407,ARUNACHAL PRADESH
2013-14,12,15324,7547,7777,ARUNACHAL PRADESH
2012-13,8,30314,15083,15231,ARUNACHAL PRADESH
2012-13,9,25486,12002,13484,ARUNACHAL PRADESH
2012-13,10,22752,10947,11805,ARUNACHAL PRADESH
2012-13,11,15964,7661,8303,ARUNACHAL PRADESH
2012-13,12,14848,6984,7864,ARUNACHAL PRADESH
2016-17,8,564533,293201,271332,ASSAM
2016-17,9,546782,284229,262553,ASSAM
2016-17,10,430946,222501,208445,ASSAM
2016-17,11,231876,113939,117937,ASSAM
2016-17,12,207233,99439,107794,ASSAM
2015-16,8,537940,279266,258674,ASSAM
2015-16,9,543437,281388,262049,ASSAM
2015-16,10,422203,218710,203493,ASSAM
2015-16,11,229691,109223,120468,ASSAM
2015-16,12,199102,95355,103747,ASSAM
2014-15,8,578038,300081,277957,ASSAM
2014-15,9,535405,279632,255773,ASSAM
2014-15,10,406365,211424,194941,ASSAM
2014-15,11,186269,90460,95809,ASSAM
2014-15,12,190630,93609,97021,ASSAM
2013-14,8,587946,304371,283575,ASSAM
2013-14,9,517378,271334,246044,ASSAM
2013-14,10,392792,206005,186787,ASSAM
2013-14,11,201400,98396,103004,ASSAM
2013-14,12,163655,79455,84200,ASSAM
2012-13,8,575442,297752,277690,ASSAM
2012-13,9,502865,263456,239409,ASSAM
2012-13,10,361852,188084,173768,ASSAM
2012-13,11,167094,80989,86105,ASSAM
2012-13,12,148459,72629,75830,ASSAM
2016-17,8,2220132,1130593,1089539,BIHAR
2016-17,9,1716740,867037,849703,BIHAR
2016-17,10,1632166,820555,811611,BIHAR
2016-17,11,419463,179561,239902,BIHAR
2016-17,12,581152,278090,303062,BIHAR
2015-16,8,2304150,1170384,1133766,BIHAR
2015-16,9,1805886,912563,893323,BIHAR
2015-16,10,1615541,792177,823364,BIHAR
2015-16,11,634811,298735,336076,BIHAR
2015-16,12,601614,275002,326612,BIHAR
2014-15,8,2122733,1077217,1045516,BIHAR
2014-15,9,1616397,799567,816830,BIHAR
2014-15,10,1421772,688636,733136,BIHAR
2014-15,11,562075,255255,306820,BIHAR
2014-15,12,519438,230750,288688,BIHAR
2013-14,8,1768836,887578,881258,BIHAR
2013-14,9,1408840,687268,721572,BIHAR
2013-14,10,1253706,593343,660363,BIHAR
2013-14,11,427435,196360,231075,BIHAR
2013-14,12,370917,169502,201415,BIHAR
2012-13,8,1456188,732870,723318,BIHAR
2012-13,9,1295375,626061,669314,BIHAR
2012-13,10,1132480,532795,599685,BIHAR
2012-13,11,332276,153828,178448,BIHAR
2012-13,12,270874,118869,152005,BIHAR
2016-17,8,21692,9913,11779,CHANDIGARH
2016-17,9,22797,9796,13001,CHANDIGARH
2016-17,10,18588,8491,10097,CHANDIGARH
2016-17,11,21767,9273,12494,CHANDIGARH
2016-17,12,18092,7906,10186,CHANDIGARH
2015-16,8,21295,9488,11807,CHANDIGARH
2015-16,9,22579,9737,12842,CHANDIGARH
2015-16,10,17673,7931,9742,CHANDIGARH
2015-16,11,21271,9029,12242,CHANDIGARH
2015-16,12,18637,8041,10596,CHANDIGARH
2014-15,8,21321,9406,11915,CHANDIGARH
2014-15,9,21545,9140,12405,CHANDIGARH
2014-15,10,16708,7600,9108,CHANDIGARH
2014-15,11,20948,8790,12158,CHANDIGARH
2014-15,12,17943,7681,10262,CHANDIGARH
2013-14,8,20498,8848,11650,CHANDIGARH
2013-14,9,20236,8826,11410,CHANDIGARH
2013-14,10,17691,7737,9954,CHANDIGARH
2013-14,11,20372,8420,11952,CHANDIGARH
2013-14,12,17261,7726,9535,CHANDIGARH
2012-13,8,20193,8868,11325,CHANDIGARH
2012-13,9,18479,8070,10409,CHANDIGARH
2012-13,10,17294,7513,9781,CHANDIGARH
2012-13,11,20296,8695,11601,CHANDIGARH
2012-13,12,15750,7144,8606,CHANDIGARH
2016-17,8,531875,266455,265420,CHHATTISGARH
2016-17,9,518240,256616,261624,CHHATTISGARH
2016-17,10,425463,223159,202304,CHHATTISGARH
2016-17,11,277274,144149,133125,CHHATTISGARH
2016-17,12,277695,138244,139451,CHHATTISGARH
2015-16,8,537703,265137,272566,CHHATTISGARH
2015-16,9,530086,262051,268035,CHHATTISGARH
2015-16,10,459617,239240,220377,CHHATTISGARH
2015-16,11,268886,137133,131753,CHHATTISGARH
2015-16,12,281511,135927,145584,CHHATTISGARH
2014-15,8,543418,268859,274559,CHHATTISGARH
2014-15,9,555732,275442,280290,CHHATTISGARH
2014-15,10,436551,224799,211752,CHHATTISGARH
2014-15,11,269160,135097,134063,CHHATTISGARH
2014-15,12,286756,135555,151201,CHHATTISGARH
2013-14,8,560229,278443,281786,CHHATTISGARH
2013-14,9,530387,263664,266723,CHHATTISGARH
2013-14,10,451710,229030,222680,CHHATTISGARH
2013-14,11,265814,131724,134090,CHHATTISGARH
2013-14,12,262673,123407,139266,CHHATTISGARH
2012-13,8,548879,272014,276865,CHHATTISGARH
2012-13,9,461228,227768,233460,CHHATTISGARH
2012-13,10,423065,214622,208443,CHHATTISGARH
2012-13,11,231373,113593,117780,CHHATTISGARH
2012-13,12,221383,101177,120206,CHHATTISGARH
2016-17,8,7306,3377,3929,DADRA & NAGAR HAVELI
2016-17,9,7529,3354,4175,DADRA & NAGAR HAVELI
2016-17,10,5779,2687,3092,DADRA & NAGAR HAVELI
2016-17,11,3135,1420,1715,DADRA & NAGAR HAVELI
2016-17,12,3871,1918,1953,DADRA & NAGAR HAVELI
2015-16,8,7590,3548,4042,DADRA & NAGAR HAVELI
2015-16,9,6982,3057,3925,DADRA & NAGAR HAVELI
2015-16,10,5948,2774,3174,DADRA & NAGAR HAVELI
2015-16,11,4424,2072,2352,DADRA & NAGAR HAVELI
2015-16,12,2140,1047,1093,DADRA & NAGAR HAVELI
2014-15,8,7426,3377,4049,DADRA & NAGAR HAVELI
2014-15,9,6732,3037,3695,DADRA & NAGAR HAVELI
2014-15,10,5884,2700,3184,DADRA & NAGAR HAVELI
2014-15,11,2419,1110,1309,DADRA & NAGAR HAVELI
2014-15,12,2584,1258,1326,DADRA & NAGAR HAVELI
2013-14,8,7289,3361,3928,DADRA & NAGAR HAVELI
2013-14,9,6398,2875,3523,DADRA & NAGAR HAVELI
2013-14,10,5239,2346,2893,DADRA & NAGAR HAVELI
2013-14,11,2787,1331,1456,DADRA & NAGAR HAVELI
2013-14,12,2320,1066,1254,DADRA & NAGAR HAVELI
2012-13,8,6945,3204,3741,DADRA & NAGAR HAVELI
2012-13,9,5588,2469,3119,DADRA & NAGAR HAVELI
2012-13,10,5011,2241,2770,DADRA & NAGAR HAVELI
2012-13,11,2592,1123,1469,DADRA & NAGAR HAVELI
2012-13,12,3363,1426,1937,DADRA & NAGAR HAVELI
2016-17,8,3242,1518,1724,DAMAN & DIU
2016-17,9,3263,1531,1732,DAMAN & DIU
2016-17,10,2847,1323,1524,DAMAN & DIU
2016-17,11,1974,979,995,DAMAN & DIU
2016-17,12,1579,783,796,DAMAN & DIU
2015-16,8,3170,1498,1672,DAMAN & DIU
2015-16,9,3250,1440,1810,DAMAN & DIU
2015-16,10,2836,1355,1481,DAMAN & DIU
2015-16,11,1221,585,636,DAMAN & DIU
2015-16,12,990,499,491,DAMAN & DIU
2014-15,8,3273,1474,1799,DAMAN & DIU
2014-15,9,3094,1435,1659,DAMAN & DIU
2014-15,10,2905,1330,1575,DAMAN & DIU
2014-15,11,1655,774,881,DAMAN & DIU
2014-15,12,2040,1036,1004,DAMAN & DIU
2013-14,8,3102,1431,1671,DAMAN & DIU
2013-14,9,3149,1435,1714,DAMAN & DIU
2013-14,10,2555,1207,1348,DAMAN & DIU
2013-14,11,2251,1084,1167,DAMAN & DIU
2013-14,12,1956,943,1013,DAMAN & DIU
2012-13,8,3081,1404,1677,DAMAN & DIU
2012-13,9,2708,1250,1458,DAMAN & DIU
2012-13,10,2727,1362,1365,DAMAN & DIU
2012-13,11,1979,900,1079,DAMAN & DIU
2012-13,12,1926,881,1045,DAMAN & DIU
2016-17,8,369092,171318,197774,DELHI
2016-17,9,452824,213369,239455,DELHI
2016-17,10,288107,136008,152099,DELHI
2016-17,11,266239,128156,138083,DELHI
2016-17,12,225566,110888,114678,DELHI
2015-16,8,371265,175645,195620,DELHI
2015-16,9,428455,194757,233698,DELHI
2015-16,10,263226,126391,136835,DELHI
2015-16,11,281788,133575,148213,DELHI
2015-16,12,234682,115447,119235,DELHI
2014-15,8,366552,168354,198198,DELHI
2014-15,9,397640,179895,217745,DELHI
2014-15,10,254503,122057,132446,DELHI
2014-15,11,320633,148239,172394,DELHI
2014-15,12,241144,118736,122408,DELHI
2013-14,8,361145,164950,196195,DELHI
2013-14,9,346261,155769,190492,DELHI
2013-14,10,297209,138076,159133,DELHI
2013-14,11,334839,152999,181840,DELHI
2013-14,12,265177,130570,134607,DELHI
2012-13,8,341284,156447,184837,DELHI
2012-13,9,329270,147561,181709,DELHI
2012-13,10,315002,146235,168767,DELHI
2012-13,11,346775,158248,188527,DELHI
2012-13,12,233342,113896,119446,DELHI
2016-17,8,23490,11104,12386,GOA
2016-17,9,28476,12710,15766,GOA
2016-17,10,19837,10012,9825,GOA
2016-17,11,19832,9996,9836,GOA
2016-17,12,17244,8940,8304,GOA
2015-16,8,24127,11499,12628,GOA
2015-16,9,29566,13386,16180,GOA
2015-16,10,21098,10624,10474,GOA
2015-16,11,19763,9687,10076,GOA
2015-16,12,15990,8311,7679,GOA
2014-15,8,24390,11681,12709,GOA
2014-15,9,30620,13578,17042,GOA
2014-15,10,20677,10207,10470,GOA
2014-15,11,18876,9257,9619,GOA
2014-15,12,16170,8466,7704,GOA
2013-14,8,18856,9289,9567,GOA
2013-14,9,12050,5981,6069,GOA
2013-14,10,26497,12295,14202,GOA
2013-14,11,28417,12743,15674,GOA
2013-14,12,19116,9465,9651,GOA
2012-13,8,23883,11097,12786,GOA
2012-13,9,25937,11838,14099,GOA
2012-13,10,19184,9533,9651,GOA
2012-13,11,13736,6399,7337,GOA
2012-13,12,12350,6275,6075,GOA
2016-17,8,1123905,506960,616945,GUJARAT
2016-17,9,930398,391750,538648,GUJARAT
2016-17,10,817015,336126,480889,GUJARAT
2016-17,11,495305,220712,274593,GUJARAT
2016-17,12,449899,200973,248926,GUJARAT
2015-16,8,1094913,491614,603299,GUJARAT
2015-16,9,913469,378340,535129,GUJARAT
2015-16,10,824156,336461,487695,GUJARAT
2015-16,11,480304,213600,266704,GUJARAT
2015-16,12,470499,207042,263457,GUJARAT
2014-15,8,1077290,479173,598117,GUJARAT
2014-15,9,910360,373259,537101,GUJARAT
2014-15,10,836025,344693,491332,GUJARAT
2014-15,11,505235,218294,286941,GUJARAT
2014-15,12,480737,210260,270477,GUJARAT
2013-14,8,1057298,468724,588574,GUJARAT
2013-14,9,919458,382143,537315,GUJARAT
2013-14,10,799874,322473,477401,GUJARAT
2013-14,11,521119,224047,297072,GUJARAT
2013-14,12,462104,198913,263191,GUJARAT
2012-13,8,1041140,468158,572982,GUJARAT
2012-13,9,803800,331517,472283,GUJARAT
2012-13,10,727370,297653,429717,GUJARAT
2012-13,11,463047,198942,264105,GUJARAT
2012-13,12,446399,193090,253309,GUJARAT
2016-17,8,472895,213677,259218,HARYANA
2016-17,9,478040,211821,266219,HARYANA
2016-17,10,423277,185253,238024,HARYANA
2016-17,11,324986,143218,181768,HARYANA
2016-17,12,282816,124629,158187,HARYANA
2015-16,8,462240,209948,252292,HARYANA
2015-16,9,456586,200143,256443,HARYANA
2015-16,10,422504,185481,237023,HARYANA
2015-16,11,292046,129804,162242,HARYANA
2015-16,12,303909,133727,170182,HARYANA
2014-15,8,476340,213403,262937,HARYANA
2014-15,9,447347,195511,251836,HARYANA
2014-15,10,416612,182386,234226,HARYANA
2014-15,11,321562,140752,180810,HARYANA
2014-15,12,311839,135366,176473,HARYANA
2013-14,8,468343,209350,258993,HARYANA
2013-14,9,428038,188994,239044,HARYANA
2013-14,10,420216,185215,235001,HARYANA
2013-14,11,318382,139696,178686,HARYANA
2013-14,12,306402,135218,171184,HARYANA
2012-13,8,438203,195483,242720,HARYANA
2012-13,9,415865,184842,231023,HARYANA
2012-13,10,399102,177060,222042,HARYANA
2012-13,11,301752,133704,168048,HARYANA
2012-13,12,286022,127876,158146,HARYANA
2016-17,8,124508,59071,65437,HIMACHAL PRADESH
2016-17,9,125735,58755,66980,HIMACHAL PRADESH
2016-17,10,122474,57156,65318,HIMACHAL PRADESH
2016-17,11,112047,52348,59699,HIMACHAL PRADESH
2016-17,12,106119,50501,55618,HIMACHAL PRADESH
2015-16,8,121808,57629,64179,HIMACHAL PRADESH
2015-16,9,126550,58574,67976,HIMACHAL PRADESH
2015-16,10,129347,59755,69592,HIMACHAL PRADESH
2015-16,11,117108,54804,62304,HIMACHAL PRADESH
2015-16,12,109489,52376,57113,HIMACHAL PRADESH
2014-15,8,122413,57756,64657,HIMACHAL PRADESH
2014-15,9,130258,59760,70498,HIMACHAL PRADESH
2014-15,10,135253,63053,72200,HIMACHAL PRADESH
2014-15,11,119932,56005,63927,HIMACHAL PRADESH
2014-15,12,98924,47797,51127,HIMACHAL PRADESH
2013-14,8,124842,58287,66555,HIMACHAL PRADESH
2013-14,9,135662,62566,73096,HIMACHAL PRADESH
2013-14,10,150191,69918,80273,HIMACHAL PRADESH
2013-14,11,106671,50529,56142,HIMACHAL PRADESH
2013-14,12,108861,52606,56255,HIMACHAL PRADESH
2012-13,8,127230,59448,67782,HIMACHAL PRADESH
2012-13,9,140121,64895,75226,HIMACHAL PRADESH
2012-13,10,146665,69220,77445,HIMACHAL PRADESH
2012-13,11,119828,56780,63048,HIMACHAL PRADESH
2012-13,12,103884,50375,53509,HIMACHAL PRADESH
2016-17,8,184837,86372,98465,JAMMU & KASHMIR
2016-17,9,173291,79985,93306,JAMMU & KASHMIR
2016-17,10,138900,64571,74329,JAMMU & KASHMIR
2016-17,11,113799,51728,62071,JAMMU & KASHMIR
2016-17,12,108874,49482,59392,JAMMU & KASHMIR
2015-16,8,196737,93203,103534,JAMMU & KASHMIR
2015-16,9,181043,84336,96707,JAMMU & KASHMIR
2015-16,10,157306,73657,83649,JAMMU & KASHMIR
2015-16,11,121548,55257,66291,JAMMU & KASHMIR
2015-16,12,125070,57471,67599,JAMMU & KASHMIR
2014-15,8,203537,96380,107157,JAMMU & KASHMIR
2014-15,9,192567,89702,102865,JAMMU & KASHMIR
2014-15,10,146066,67614,78452,JAMMU & KASHMIR
2014-15,11,138963,62850,76113,JAMMU & KASHMIR
2014-15,12,116187,52899,63288,JAMMU & KASHMIR
2013-14,8,211178,99730,111448,JAMMU & KASHMIR
2013-14,9,195139,89995,105144,JAMMU & KASHMIR
2013-14,10,145849,67448,78401,JAMMU & KASHMIR
2013-14,11,122667,54843,67824,JAMMU & KASHMIR
2013-14,12,104286,46982,57304,JAMMU & KASHMIR
2012-13,8,219624,102434,117190,JAMMU & KASHMIR
2012-13,9,194710,89780,104930,JAMMU & KASHMIR
2012-13,10,135502,61540,73962,JAMMU & KASHMIR
2012-13,11,113012,50062,62950,JAMMU & KASHMIR
2012-13,12,97750,42904,54846,JAMMU & KASHMIR
2016-17,8,586393,294550,291843,JHARKHAND
2016-17,9,466793,232173,234620,JHARKHAND
2016-17,10,417667,208501,209166,JHARKHAND
2016-17,11,231155,109777,121378,JHARKHAND
2016-17,12,198069,94418,103651,JHARKHAND
2015-16,8,666665,336789,329876,JHARKHAND
2015-16,9,539232,266011,273221,JHARKHAND
2015-16,10,486561,241547,245014,JHARKHAND
2015-16,11,279319,132928,146391,JHARKHAND
2015-16,12,280316,131116,149200,JHARKHAND
2014-15,8,670633,337266,333367,JHARKHAND
2014-15,9,536645,263779,272866,JHARKHAND
2014-15,10,477383,235882,241501,JHARKHAND
2014-15,11,288494,136286,152208,JHARKHAND
2014-15,12,273585,127224,146361,JHARKHAND
2013-14,8,662009,332789,329220,JHARKHAND
2013-14,9,521708,254848,266860,JHARKHAND
2013-14,10,482484,233161,249323,JHARKHAND
2013-14,11,266042,124692,141350,JHARKHAND
2013-14,12,240614,110853,129761,JHARKHAND
2012-13,8,621141,309353,311788,JHARKHAND
2012-13,9,492239,237780,254459,JHARKHAND
2012-13,10,435094,209141,225953,JHARKHAND
2012-13,11,204462,92685,111777,JHARKHAND
2012-13,12,183075,84124,98951,JHARKHAND
2016-17,8,935455,447592,487863,KARNATAKA
2016-17,9,904856,429842,475014,KARNATAKA
2016-17,10,895394,427561,467833,KARNATAKA
2016-17,11,24554,11806,12748,KARNATAKA
2016-17,12,2098,966,1132,KARNATAKA
2015-16,8,961735,462741,498994,KARNATAKA
2015-16,9,921628,438811,482817,KARNATAKA
2015-16,10,852636,411168,441468,KARNATAKA
2015-16,11,450940,228689,222251,KARNATAKA
2015-16,12,363277,189267,174010,KARNATAKA
2014-15,8,990403,474682,515721,KARNATAKA
2014-15,9,916784,436940,479844,KARNATAKA
2014-15,10,850206,409509,440697,KARNATAKA
2014-15,11,368729,185022,183707,KARNATAKA
2014-15,12,311613,162785,148828,KARNATAKA
2013-14,8,962361,459883,502478,KARNATAKA
2013-14,9,896324,429656,466668,KARNATAKA
2013-14,10,789011,380636,408375,KARNATAKA
2013-14,11,206019,105516,100503,KARNATAKA
2013-14,12,177355,93778,83577,KARNATAKA
2012-13,8,968336,464721,503615,KARNATAKA
2012-13,9,865645,413529,452116,KARNATAKA
2012-13,10,800950,388999,411951,KARNATAKA
2012-13,11,208824,105290,103534,KARNATAKA
2012-13,12,176553,90502,86051,KARNATAKA
2016-17,8,517666,252890,264776,KERALA
2016-17,9,530872,256112,274760,KERALA
2016-17,10,534311,261246,273065,KERALA
2016-17,11,420372,218977,201395,KERALA
2016-17,12,403512,211729,191783,KERALA
2015-16,8,525601,256314,269287,KERALA
2015-16,9,545641,263165,282476,KERALA
2015-16,10,552608,269913,282695,KERALA
2015-16,11,412089,214418,197671,KERALA
2015-16,12,393051,204797,188254,KERALA
2014-15,8,541423,263687,277736,KERALA
2014-15,9,563010,271019,291991,KERALA
2014-15,10,542420,265551,276869,KERALA
2014-15,11,395041,203792,191249,KERALA
2014-15,12,373520,195866,177654,KERALA
2013-14,8,555588,270826,284762,KERALA
2013-14,9,564898,270099,294799,KERALA
2013-14,10,537538,260922,276616,KERALA
2013-14,11,399093,208127,190966,KERALA
2013-14,12,388238,202123,186115,KERALA
2012-13,8,542176,262647,279529,KERALA
2012-13,9,527944,250856,277088,KERALA
2012-13,10,516156,252700,263456,KERALA
2012-13,11,333546,173484,160062,KERALA
2012-13,12,299666,157086,142580,KERALA
2016-17,8,1024,524,500,LAKSHADWEEP
2016-17,9,1254,642,612,LAKSHADWEEP
2016-17,10,1230,607,623,LAKSHADWEEP
2016-17,11,1039,561,478,LAKSHADWEEP
2016-17,12,1352,791,561,LAKSHADWEEP
2015-16,8,1088,567,521,LAKSHADWEEP
2015-16,9,1406,681,725,LAKSHADWEEP
2015-16,10,1112,605,507,LAKSHADWEEP
2015-16,11,1404,809,595,LAKSHADWEEP
2015-16,12,994,542,452,LAKSHADWEEP
2014-15,8,1202,625,577,LAKSHADWEEP
2014-15,9,1486,727,759,LAKSHADWEEP
2014-15,10,1459,846,613,LAKSHADWEEP
2014-15,11,1026,560,466,LAKSHADWEEP
2014-15,12,964,452,512,LAKSHADWEEP
2013-14,8,1240,656,584,LAKSHADWEEP
2013-14,9,1835,982,853,LAKSHADWEEP
2013-14,10,1166,639,527,LAKSHADWEEP
2013-14,11,992,464,528,LAKSHADWEEP
2013-14,12,1007,453,554,LAKSHADWEEP
2012-13,8,1649,892,757,LAKSHADWEEP
2012-13,9,1341,681,660,LAKSHADWEEP
2012-13,10,1094,551,543,LAKSHADWEEP
2012-13,11,1078,507,571,LAKSHADWEEP
2012-13,12,974,486,488,LAKSHADWEEP
2016-17,8,1514929,730300,784629,MADHYA PRADESH
2016-17,9,1473107,689819,783288,MADHYA PRADESH
2016-17,10,1093602,498045,595557,MADHYA PRADESH
2016-17,11,680839,318016,362823,MADHYA PRADESH
2016-17,12,655126,293936,361190,MADHYA PRADESH
2015-16,8,1511375,741139,770236,MADHYA PRADESH
2015-16,9,1467054,682261,784793,MADHYA PRADESH
2015-16,10,1110670,505986,604684,MADHYA PRADESH
2015-16,11,621173,284526,336647,MADHYA PRADESH
2015-16,12,661792,292730,369062,MADHYA PRADESH
2014-15,8,1561485,764401,797084,MADHYA PRADESH
2014-15,9,1485088,695336,789752,MADHYA PRADESH
2014-15,10,1059059,488291,570768,MADHYA PRADESH
2014-15,11,614002,277265,336737,MADHYA PRADESH
2014-15,12,662257,289768,372489,MADHYA PRADESH
2013-14,8,1606484,797363,809121,MADHYA PRADESH
2013-14,9,1494364,707284,787080,MADHYA PRADESH
2013-14,10,1057325,488192,569133,MADHYA PRADESH
2013-14,11,635004,284166,350838,MADHYA PRADESH
2013-14,12,573460,246364,327096,MADHYA PRADESH
2012-13,8,1594869,798957,795912,MADHYA PRADESH
2012-13,9,1276438,611151,665287,MADHYA PRADESH
2012-13,10,886804,411070,475734,MADHYA PRADESH
2012-13,11,459458,202483,256975,MADHYA PRADESH
2012-13,12,460541,195976,264565,MADHYA PRADESH
2016-17,8,2008417,936695,1071722,MAHARASHTRA
2016-17,9,1944124,886409,1057715,MAHARASHTRA
2016-17,10,1810025,814440,995585,MAHARASHTRA
2016-17,11,1448427,665352,783075,MAHARASHTRA
2016-17,12,1412078,646816,765262,MAHARASHTRA
2015-16,8,1961219,908243,1052976,MAHARASHTRA
2015-16,9,1953159,875301,1077858,MAHARASHTRA
2015-16,10,1727559,791582,935977,MAHARASHTRA
2015-16,11,1450001,663753,786248,MAHARASHTRA
2015-16,12,1292806,593300,699506,MAHARASHTRA
2014-15,8,1956811,901532,1055279,MAHARASHTRA
2014-15,9,1970514,889666,1080848,MAHARASHTRA
2014-15,10,1694545,780971,913574,MAHARASHTRA
2014-15,11,1313517,601991,711526,MAHARASHTRA
2014-15,12,1201964,554348,647616,MAHARASHTRA
2013-14,8,1933584,892763,1040821,MAHARASHTRA
2013-14,9,1915538,868191,1047347,MAHARASHTRA
2013-14,10,1615313,740164,875149,MAHARASHTRA
2013-14,11,1237438,575389,662049,MAHARASHTRA
2013-14,12,1142910,528327,614583,MAHARASHTRA
2012-13,8,1906193,882007,1024186,MAHARASHTRA
2012-13,9,1830298,828108,1002190,MAHARASHTRA
2012-13,10,1590500,737645,852855,MAHARASHTRA
2012-13,11,1173734,548612,625122,MAHARASHTRA
2012-13,12,1030768,479237,551531,MAHARASHTRA
2016-17,8,48146,24010,24136,MANIPUR
2016-17,9,42234,20686,21548,MANIPUR
2016-17,10,37317,18588,18729,MANIPUR
2016-17,11,30236,14618,15618,MANIPUR
2016-17,12,26874,13064,13810,MANIPUR
2015-16,8,50709,25097,25612,MANIPUR
2015-16,9,43726,21612,22114,MANIPUR
2015-16,10,41844,20401,21443,MANIPUR
2015-16,11,30474,14621,15853,MANIPUR
2015-16,12,29823,14197,15626,MANIPUR
2014-15,8,49619,24807,24812,MANIPUR
2014-15,9,43564,21316,22248,MANIPUR
2014-15,10,40731,20214,20517,MANIPUR
2014-15,11,28369,13486,14883,MANIPUR
2014-15,12,28908,14066,14842,MANIPUR
2013-14,8,50141,24560,25581,MANIPUR
2013-14,9,42297,21053,21244,MANIPUR
2013-14,10,38248,18895,19353,MANIPUR
2013-14,11,29291,14161,15130,MANIPUR
2013-14,12,25899,12143,13756,MANIPUR
2012-13,8,48823,24140,24683,MANIPUR
2012-13,9,39594,19684,19910,MANIPUR
2012-13,10,35457,17724,17733,MANIPUR
2012-13,11,27947,13435,14512,MANIPUR
2012-13,12,28631,13692,14939,MANIPUR
2016-17,8,64076,33917,30159,MEGHALAYA
2016-17,9,54880,29244,25636,MEGHALAYA
2016-17,10,45752,24577,21175,MEGHALAYA
2016-17,11,26534,14084,12450,MEGHALAYA
2016-17,12,23604,12432,11172,MEGHALAYA
2015-16,8,69064,36740,32324,MEGHALAYA
2015-16,9,58367,30880,27487,MEGHALAYA
2015-16,10,47128,25346,21782,MEGHALAYA
2015-16,11,27359,14433,12926,MEGHALAYA
2015-16,12,26224,14253,11971,MEGHALAYA
2014-15,8,66036,34987,31049,MEGHALAYA
2014-15,9,56199,29967,26232,MEGHALAYA
2014-15,10,43331,23068,20263,MEGHALAYA
2014-15,11,22372,12434,9938,MEGHALAYA
2014-15,12,22122,12152,9970,MEGHALAYA
2013-14,8,63510,34064,29446,MEGHALAYA
2013-14,9,51814,27544,24270,MEGHALAYA
2013-14,10,40372,21759,18613,MEGHALAYA
2013-14,11,15639,8845,6794,MEGHALAYA
2013-14,12,12953,7412,5541,MEGHALAYA
2012-13,8,57758,30683,27075,MEGHALAYA
2012-13,9,45725,24624,21101,MEGHALAYA
2012-13,10,35413,19080,16333,MEGHALAYA
2012-13,11,11645,6804,4841,MEGHALAYA
2012-13,12,10328,5910,4418,MEGHALAYA
2016-17,8,20780,9990,10790,MIZORAM
2016-17,9,20773,10110,10663,MIZORAM
2016-17,10,15756,8202,7554,MIZORAM
2016-17,11,11582,5938,5644,MIZORAM
2016-17,12,10958,5646,5312,MIZORAM
2015-16,8,21559,10296,11263,MIZORAM
2015-16,9,22110,10910,11200,MIZORAM
2015-16,10,19424,9800,9624,MIZORAM
2015-16,11,11258,5748,5510,MIZORAM
2015-16,12,11728,6001,5727,MIZORAM
2014-15,8,21783,10711,11072,MIZORAM
2014-15,9,20964,10161,10803,MIZORAM
2014-15,10,19747,10047,9700,MIZORAM
2014-15,11,11890,5981,5909,MIZORAM
2014-15,12,10672,5229,5443,MIZORAM
2013-14,8,20625,9994,10631,MIZORAM
2013-14,9,20447,9828,10619,MIZORAM
2013-14,10,20111,10236,9875,MIZORAM
2013-14,11,9838,4892,4946,MIZORAM
2013-14,12,11646,5966,5680,MIZORAM
2012-13,8,24156,11710,12446,MIZORAM
2012-13,9,21502,10540,10962,MIZORAM
2012-13,10,17983,9136,8847,MIZORAM
2012-13,11,10318,5086,5232,MIZORAM
2012-13,12,9922,4943,4979,MIZORAM
2016-17,8,30321,14915,15406,NAGALAND
2016-17,9,31001,15394,15607,NAGALAND
2016-17,10,20099,10328,9771,NAGALAND
2016-17,11,16838,8249,8589,NAGALAND
2016-17,12,14256,7168,7088,NAGALAND
2015-16,8,34441,16955,17486,NAGALAND
2015-16,9,36306,18001,18305,NAGALAND
2015-16,10,22909,11566,11343,NAGALAND
2015-16,11,17318,8465,8853,NAGALAND
2015-16,12,13884,6823,7061,NAGALAND
2014-15,8,35207,17458,17749,NAGALAND
2014-15,9,32771,16440,16331,NAGALAND
2014-15,10,20241,10147,10094,NAGALAND
2014-15,11,15213,7201,8012,NAGALAND
2014-15,12,12897,6417,6480,NAGALAND
2013-14,8,39173,19535,19638,NAGALAND
2013-14,9,34741,17354,17387,NAGALAND
2013-14,10,22338,11198,11140,NAGALAND
2013-14,11,15057,7348,7709,NAGALAND
2013-14,12,12137,5763,6374,NAGALAND
2012-13,8,40004,19784,20220,NAGALAND
2012-13,9,31000,15545,15455,NAGALAND
2012-13,10,22250,10963,11287,NAGALAND
2012-13,11,15130,7030,8100,NAGALAND
2012-13,12,13738,6633,7105,NAGALAND
2016-17,8,702028,339575,362453,ODISHA
2016-17,9,641597,313820,327777,ODISHA
2016-17,10,613683,305937,307746,ODISHA
2016-17,11,275852,136023,139829,ODISHA
2016-17,12,270128,132038,138090,ODISHA
2015-16,8,701864,341677,360187,ODISHA
2015-16,9,648573,320664,327909,ODISHA
2015-16,10,602052,300302,301750,ODISHA
2015-16,11,260950,127992,132958,ODISHA
2015-16,12,236606,116740,119866,ODISHA
2014-15,8,698267,343160,355107,ODISHA
2014-15,9,632564,311743,320821,ODISHA
2014-15,10,592997,294808,298189,ODISHA
2014-15,11,13086,6049,7037,ODISHA
2014-15,12,11644,5383,6261,ODISHA
2013-14,8,664001,324584,339417,ODISHA
2013-14,9,628911,309937,318974,ODISHA
2013-14,10,577088,289375,287713,ODISHA
2013-14,11,9247,4006,5241,ODISHA
2013-14,12,8235,3632,4603,ODISHA
2012-13,8,656959,321652,335307,ODISHA
2012-13,9,644873,316468,328405,ODISHA
2012-13,10,557341,281767,275574,ODISHA
2012-13,11,8151,3517,4634,ODISHA
2012-13,12,7192,3204,3988,ODISHA
2012-13,8,24506,12026,12480,PONDICHERRY
2012-13,9,25295,12018,13277,PONDICHERRY
2012-13,10,21290,10554,10736,PONDICHERRY
2012-13,11,16618,8785,7833,PONDICHERRY
2012-13,12,13886,7604,6282,PONDICHERRY
2016-17,8,21008,10185,10823,PONDICHERRY
2016-17,9,23199,11001,12198,PONDICHERRY
2016-17,10,20318,9982,10336,PONDICHERRY
2016-17,11,17735,9291,8444,PONDICHERRY
2016-17,12,16964,9067,7897,PONDICHERRY
2015-16,8,22207,10707,11500,PONDICHERRY
2015-16,9,23491,11069,12422,PONDICHERRY
2015-16,10,20743,10480,10263,PONDICHERRY
2015-16,11,18977,9883,9094,PONDICHERRY
2015-16,12,16010,8546,7464,PONDICHERRY
2014-15,8,22249,10654,11595,PONDICHERRY
2014-15,9,23873,11544,12329,PONDICHERRY
2014-15,10,22494,11264,11230,PONDICHERRY
2014-15,11,17017,8982,8035,PONDICHERRY
2014-15,12,15274,8247,7027,PONDICHERRY
2013-14,8,22480,11121,11359,PONDICHERRY
2013-14,9,26245,12569,13676,PONDICHERRY
2013-14,10,21046,10389,10657,PONDICHERRY
2013-14,11,17226,9054,8172,PONDICHERRY
2013-14,12,15140,8254,6886,PONDICHERRY
2016-17,8,480176,216089,264087,PUNJAB
2016-17,9,461242,199767,261475,PUNJAB
2016-17,10,426461,185278,241183,PUNJAB
2016-17,11,373535,165183,208352,PUNJAB
2016-17,12,338148,152091,186057,PUNJAB
2015-16,8,473949,209017,264932,PUNJAB
2015-16,9,455303,195256,260047,PUNJAB
2015-16,10,432139,188343,243796,PUNJAB
2015-16,11,357890,159196,198694,PUNJAB
2015-16,12,333628,149372,184256,PUNJAB
2014-15,8,473349,206611,266738,PUNJAB
2014-15,9,451412,195022,256390,PUNJAB
2014-15,10,426034,187226,238808,PUNJAB
2014-15,11,351639,154212,197427,PUNJAB
2014-15,12,342835,155278,187557,PUNJAB
2013-14,8,469897,207087,262810,PUNJAB
2013-14,9,459425,198659,260766,PUNJAB
2013-14,10,404421,178694,225727,PUNJAB
2013-14,11,363595,160238,203357,PUNJAB
2013-14,12,326186,148614,177572,PUNJAB
2012-13,8,490108,213820,276288,PUNJAB
2012-13,9,423062,186503,236559,PUNJAB
2012-13,10,434700,193393,241307,PUNJAB
2012-13,11,355040,158733,196307,PUNJAB
2012-13,12,296196,137161,159035,PUNJAB
2016-17,8,1288995,581190,707805,RAJASTHAN
2016-17,9,1218649,531828,686821,RAJASTHAN
2016-17,10,1130073,485344,644729,RAJASTHAN
2016-17,11,812991,341523,471468,RAJASTHAN
2016-17,12,872300,358623,513677,RAJASTHAN
2015-16,8,1258976,562444,696532,RAJASTHAN
2015-16,9,1214024,525376,688648,RAJASTHAN
2015-16,10,1117215,467798,649417,RAJASTHAN
2015-16,11,845021,354113,490908,RAJASTHAN
2015-16,12,812314,319796,492518,RAJASTHAN
2014-15,8,1224944,541498,683446,RAJASTHAN
2014-15,9,1192043,503950,688093,RAJASTHAN
2014-15,10,1128129,468793,659336,RAJASTHAN
2014-15,11,745354,303100,442254,RAJASTHAN
2014-15,12,820232,319959,500273,RAJASTHAN
2013-14,8,1257697,555965,701732,RAJASTHAN
2013-14,9,1216241,519204,697037,RAJASTHAN
2013-14,10,1147590,471370,676220,RAJASTHAN
2013-14,11,751214,301332,449882,RAJASTHAN
2013-14,12,694784,261457,433327,RAJASTHAN
2012-13,8,1273868,565174,708694,RAJASTHAN
2012-13,9,1096079,455220,640859,RAJASTHAN
2012-13,10,1149358,469043,680315,RAJASTHAN
2012-13,11,593817,236487,357330,RAJASTHAN
2012-13,12,714644,267178,447466,RAJASTHAN
2016-17,8,13089,6744,6345,SIKKIM
2016-17,9,15080,7763,7317,SIKKIM
2016-17,10,10392,5494,4898,SIKKIM
2016-17,11,8819,4736,4083,SIKKIM
2016-17,12,7219,4072,3147,SIKKIM
2015-16,8,14320,7340,6980,SIKKIM
2015-16,9,16115,8366,7749,SIKKIM
2015-16,10,11135,5874,5261,SIKKIM
2015-16,11,9169,5032,4137,SIKKIM
2015-16,12,7870,4358,3512,SIKKIM
2014-15,8,14716,7701,7015,SIKKIM
2014-15,9,15293,7990,7303,SIKKIM
2014-15,10,10151,5444,4707,SIKKIM
2014-15,11,9207,5031,4176,SIKKIM
2014-15,12,7287,4059,3228,SIKKIM
2013-14,8,15052,7853,7199,SIKKIM
2013-14,9,12975,6979,5996,SIKKIM
2013-14,10,10118,5390,4728,SIKKIM
2013-14,11,8484,4672,3812,SIKKIM
2013-14,12,6515,3623,2892,SIKKIM
2012-13,8,12969,6993,5976,SIKKIM
2012-13,9,11240,5979,5261,SIKKIM
2012-13,10,9133,4975,4158,SIKKIM
2012-13,11,7226,3883,3343,SIKKIM
2012-13,12,5672,3061,2611,SIKKIM
2016-17,8,1173448,572455,600993,TAMIL NADU
2016-17,9,1147210,560045,587165,TAMIL NADU
2016-17,10,1109496,550993,558503,TAMIL NADU
2016-17,11,916498,482861,433637,TAMIL NADU
2016-17,12,903430,481063,422367,TAMIL NADU
2015-16,8,1176099,574196,601903,TAMIL NADU
2015-16,9,1161546,564570,596976,TAMIL NADU
2015-16,10,1096549,540311,556238,TAMIL NADU
2015-16,11,942855,496726,446129,TAMIL NADU
2015-16,12,840839,447260,393579,TAMIL NADU
2014-15,8,1190283,578005,612278,TAMIL NADU
2014-15,9,1122807,544334,578473,TAMIL NADU
2014-15,10,1103740,542530,561210,TAMIL NADU
2014-15,11,874768,460181,414587,TAMIL NADU
2014-15,12,840168,448975,391193,TAMIL NADU
2013-14,8,1243868,604365,639503,TAMIL NADU
2013-14,9,1169110,561025,608085,TAMIL NADU
2013-14,10,1091129,531135,559994,TAMIL NADU
2013-14,11,880578,469784,410794,TAMIL NADU
2013-14,12,827882,442268,385614,TAMIL NADU
2012-13,8,1249652,610030,639622,TAMIL NADU
2012-13,9,1121956,537104,584852,TAMIL NADU
2012-13,10,1080771,528776,551995,TAMIL NADU
2012-13,11,844534,453004,391530,TAMIL NADU
2012-13,12,795179,425516,369663,TAMIL NADU
2016-17,8,552253,270924,281329,telangana
2016-17,9,526787,259205,267582,telangana
2016-17,10,522027,257215,264812,telangana
2016-17,11,297731,153938,143793,telangana
2016-17,12,274837,143498,131339,telangana
2015-16,8,556342,273551,282791,telangana
2015-16,9,534804,263807,270997,telangana
2015-16,10,523324,260211,263113,telangana
2015-16,11,351122,180233,170889,telangana
2015-16,12,343166,173981,169185,telangana
2014-15,8,550441,270939,279502,telangana
2014-15,9,530002,263439,266563,telangana
2014-15,10,505184,251730,253454,telangana
2014-15,11,345818,173067,172751,telangana
2014-15,12,321752,160834,160918,telangana
2016-17,8,64231,31977,32254,TRIPURA
2016-17,9,75095,37469,37626,TRIPURA
2016-17,10,58668,29562,29106,TRIPURA
2016-17,11,27938,12942,14996,TRIPURA
2016-17,12,26776,12453,14323,TRIPURA
2015-16,8,65068,32223,32845,TRIPURA
2015-16,9,84533,42097,42436,TRIPURA
2015-16,10,56648,28261,28387,TRIPURA
2015-16,11,30089,13837,16252,TRIPURA
2015-16,12,26674,12201,14473,TRIPURA
2014-15,8,66087,32662,33425,TRIPURA
2014-15,9,87312,43141,44171,TRIPURA
2014-15,10,59662,29427,30235,TRIPURA
2014-15,11,29520,13448,16072,TRIPURA
2014-15,12,26840,11628,15212,TRIPURA
2013-14,8,65544,32145,33399,TRIPURA
2013-14,9,90028,44132,45896,TRIPURA
2013-14,10,57075,27952,29123,TRIPURA
2013-14,11,28870,12514,16356,TRIPURA
2013-14,12,24959,10793,14166,TRIPURA
2012-13,8,75022,36864,38158,TRIPURA
2012-13,9,80982,39669,41313,TRIPURA
2012-13,10,55008,26689,28319,TRIPURA
2012-13,11,27416,11878,15538,TRIPURA
2012-13,12,21932,9341,12591,TRIPURA
2016-17,8,3601052,1794526,1806526,UTTAR PRADESH
2016-17,9,3546340,1589810,1956530,UTTAR PRADESH
2016-17,10,3279643,1544922,1734721,UTTAR PRADESH
2016-17,11,2666089,1228569,1437520,UTTAR PRADESH
2016-17,12,2341500,1133020,1208480,UTTAR PRADESH
2015-16,8,3732795,1861296,1871499,UTTAR PRADESH
2015-16,9,3308247,1555673,1752574,UTTAR PRADESH
2015-16,10,3510535,1632690,1877845,UTTAR PRADESH
2015-16,11,2501585,1191338,1310247,UTTAR PRADESH
2015-16,12,2660853,1244271,1416582,UTTAR PRADESH
2014-15,8,3692986,1855617,1837369,UTTAR PRADESH
2014-15,9,3372729,1589200,1783529,UTTAR PRADESH
2014-15,10,3331344,1573288,1758056,UTTAR PRADESH
2014-15,11,2700413,1269469,1430944,UTTAR PRADESH
2014-15,12,2541247,1213193,1328054,UTTAR PRADESH
2013-14,8,3553214,1800634,1752580,UTTAR PRADESH
2013-14,9,3197516,1525878,1671638,UTTAR PRADESH
2013-14,10,3318439,1547051,1771388,UTTAR PRADESH
2013-14,11,2523490,1206734,1316756,UTTAR PRADESH
2013-14,12,2519294,1186273,1333021,UTTAR PRADESH
2012-13,8,3398993,1721056,1677937,UTTAR PRADESH
2012-13,9,2756373,1292378,1463995,UTTAR PRADESH
2012-13,10,2807406,1280813,1526593,UTTAR PRADESH
2012-13,11,2346348,1089829,1256519,UTTAR PRADESH
2012-13,12,1952762,884998,1067764,UTTAR PRADESH
2016-17,8,195917,93686,102231,UTTARAKHAND
2016-17,9,191691,90886,100805,UTTARAKHAND
2016-17,10,190924,92561,98363,UTTARAKHAND
2016-17,11,156693,75286,81407,UTTARAKHAND
2016-17,12,157040,77736,79304,UTTARAKHAND
2015-16,8,195242,93642,101600,UTTARAKHAND
2015-16,9,192095,90991,101104,UTTARAKHAND
2015-16,10,196518,94172,102346,UTTARAKHAND
2015-16,11,154103,75976,78127,UTTARAKHAND
2015-16,12,154578,76361,78217,UTTARAKHAND
2014-15,8,193890,93524,100366,UTTARAKHAND
2014-15,9,197590,94109,103481,UTTARAKHAND
2014-15,10,200769,96701,104068,UTTARAKHAND
2014-15,11,150799,74021,76778,UTTARAKHAND
2014-15,12,162100,78534,83566,UTTARAKHAND
2013-14,8,198487,95925,102562,UTTARAKHAND
2013-14,9,195014,93137,101877,UTTARAKHAND
2013-14,10,195919,93406,102513,UTTARAKHAND
2013-14,11,151870,73149,78721,UTTARAKHAND
2013-14,12,150815,73782,77033,UTTARAKHAND
2012-13,8,195553,95232,100321,UTTARAKHAND
2012-13,9,193798,93031,100767,UTTARAKHAND
2012-13,10,196320,94620,101700,UTTARAKHAND
2012-13,11,149683,73327,76356,UTTARAKHAND
2012-13,12,141656,68719,72937,UTTARAKHAND
2016-17,8,1443375,759216,684159,WEST BENGAL
2016-17,9,1479280,804834,674446,WEST BENGAL
2016-17,10,1114974,615595,499379,WEST BENGAL
2016-17,11,890084,461936,428148,WEST BENGAL
2016-17,12,726202,367245,358957,WEST BENGAL
2015-16,8,1601724,842262,759462,WEST BENGAL
2015-16,9,1528718,824402,704316,WEST BENGAL
2015-16,10,1230469,666948,563521,WEST BENGAL
2015-16,11,856384,432133,424251,WEST BENGAL
2015-16,12,780475,388748,391727,WEST BENGAL
2014-15,8,1568742,826309,742433,WEST BENGAL
2014-15,9,1505449,809631,695818,WEST BENGAL
2014-15,10,1125441,603139,522302,WEST BENGAL
2014-15,11,848918,422187,426731,WEST BENGAL
2014-15,12,747909,363641,384268,WEST BENGAL
2013-14,8,1512910,797641,715269,WEST BENGAL
2013-14,9,1420617,757691,662926,WEST BENGAL
2013-14,10,1113575,588925,524650,WEST BENGAL
2013-14,11,812307,393934,418373,WEST BENGAL
2013-14,12,722777,342444,380333,WEST BENGAL
2012-13,8,1486691,784421,702270,WEST BENGAL
2012-13,9,1342677,709624,633053,WEST BENGAL
2012-13,10,1072061,561011,511050,WEST BENGAL
2012-13,11,783587,372372,411215,WEST BENGAL
2012-13,12,695692,326068,369624,WEST BENGAL
